abandon	elhagyott
abandoned	elhagyatott
abbey	apátság
abdominal	hasi
abilities	képességeit
ability	képesség
able	képes
abnormal	rendellenes
aboard	fedélzeten
abolished	megszüntették
aboriginal	bennszülött
abortion	abortusz
about	ról ről
above	felett
abraham	Ábrahám
abroad	külföldön
absence	hiány
absent	hiányzó
absolute	abszolút
absolutely	teljesen
absorb	elnyel
absorbed	elnyelt
absorption	abszorpció
abstract	absztrakt
abundance	bőség
abundant	bőséges
abuse	visszaélés
academic	akadémiai
academy	akadémia
accelerated	felgyorsult
accent	hangsúly
accept	elfogad
acceptable	elfogadható
acceptance	elfogadás
accepted	elfogadott
accepting	elfogadó
access	hozzáférés
accessible	hozzáférhető
accessories	kiegészítők
accident	baleset
accidentally	véletlenül
accidents	balesetek
acclaim	elismerést
accommodate	befogadni
accommodation	szállás
accompanied	kísért
accompany	kísérni
accomplished	teljesítve
accordance	összhangban
according	szerint
accordingly	Eszerint
account	fiókot
accounting	könyvelés
accounts	fiókok
accumulate	felhalmozódnak
accumulated	felgyülemlett
accumulation	felhalmozódás
accuracy	pontosság
accurate	pontos
accurately	pontosan
accused	vádlott
achieve	elérni
achieved	elért
achievement	teljesítmény
achievements	eredményeket
achieving	elérése
acid	sav
acids	savak
acoustic	akusztikus
acquire	szerez
acquired	szerzett
acquisition	beszerzés
across	át
act	törvény
acting	ható
action	akció
actions	akciók
activate	aktiválja
activated	aktív
activation	aktiválás
active	aktív
actively	aktívan
activist	aktivista
activists	aktivisták
activities	tevékenységek
activity	tevékenység
actor	színész
actors	szereplők
actress	színésznő
acts	cselekszik
actual	tényleges
actually	tulajdonképpen
acute	akut
ad	hirdetés
adam	Ádám
adapt	alkalmazkodni
adaptation	alkalmazkodás
adapted	adaptált
add	add hozzá
added	tette hozzá
addiction	függőség
adding	hozzátéve
addition	kiegészítés
additional	további
additionally	ezen felül
address	cím
addressed	címzett
addresses	címek
adds	hozzáteszi
adequate	megfelelő
adhesive	ragasztóanyag
adjacent	szomszédos
adjust	beállítani
adjustable	állítható
adjusted	beállított
adjustment	beállítás
administered	beadni
administration	adminisztráció
admiral	admirális
admire	csodál
admission	belépés
admit	beismerni
admitted	felvételt nyer
adopt	örökbe fogadni
adopted	fogadott
adoption	örökbefogadás
ads	hirdetéseket
adult	felnőtt
adults	felnőttek
advance	előleg
advanced	fejlett
advances	előlegeket
advantage	előny
advantages	előnyeit
advent	megérkezés
adventure	kaland
adventures	kalandok
adverse	kedvezőtlen
advertising	hirdető
advice	tanács
advise	tanácsol
advised	tanácsolta
advisory	tanácsadó
advocate	ügyvéd
advocates	szószólói
aerial	légi
aesthetic	esztétika
affair	ügy
affairs	ügyek
affect	befolyásolni
affected	érintett
affecting	befolyásoló
affects	érinti
affiliated	kapcsolt
afford	engedheti meg magának
affordable	megfizethető
afghan	afgán
afghanistan	Afganisztán
afraid	fél
africa	Afrika
African	afrikai
after	után
aftermath	utóhatása
afternoon	délután
afterwards	később
again	újra
against	ellen
age	kor
aged	idős
agencies	ügynökségek
agency	ügynökség
agenda	napirend
agent	ügynök
ages	korok
aggregator	aggregátor
aggressive	agresszív
aging	öregedés
ago	ezelőtt
Agree	Egyetért
agreed	egyetért
agreement	megegyezés
agreements	megállapodások
agricultural	mezőgazdasági
agriculture	mezőgazdaság
ahead	előre
aid	támogatás
aim	cél
aimed	célzott
aims	célokat
air	levegő
aircraft	repülőgép
aired	sugárzott
airing	szellőztetés
airline	légitársaság
airlines	légitársaságok
airport	repülőtér
alarm	riasztás
Alaska	Alaszka
albania	Albánia
albums	albumok
alcohol	alkohol
alcoholic	alkohol függő
alert	éber
alexander	Sándor
Algeria	Algéria
algorithm	algoritmus
algorithms	algoritmusok
alien	idegen
alive	élő
all	minden
allegations	vádakat
alleged	állítólagos
allegedly	állítólag
allergic	allergiás
alliance	szövetség
allied	szövetséges
allies	szövetségesei
allocated	kiosztott
allow	lehetővé teszi
allowed	megengedett
allowing	lehetővé téve
allows	lehetővé tesz
alloy	ötvözet
almost	majdnem
alone	egyedül
along	mentén
alongside	mellett
alpha	alfa
alphabet	ábécé
alpine	alpesi
Alps	Alpok
also	is
altar	oltár
alter	változtat
altered	megváltozott
alternate	váltakozó
alternative	alternatív
alternatives	alternatívák
although	habár
altitude	magasság
aluminum	alumínium
always	mindig
amazed	csodálkozva
amazing	elképesztő
ambassador	nagykövet
ambitious	ambiciózus
amendment	módosítás
america	Amerika
American	Amerikai
americans	amerikaiak
ammunition	lőszer
among	között
amongst	között
amount	összeg
amounts	összegeket
Amsterdam	Amszterdam
analog	analóg
analysis	elemzés
analytical	elemző
analyze	elemezni
analyzed	elemezte
analyzes	elemzések
ancestors	ősök
anchor	horgony
ancient	ősi
and	és
andrew	András
android	robot emberi külsővel
anemia	anémia
angel	angyal
angeles	angyalok
angels	angyalok
anger	harag
angle	szög
angles	szögek
anglo	angol
angry	mérges
animal	állat
animals	állatokat
animated	élénk
animation	élénkség
ankle	boka
anniversary	évforduló
announce	bejelenteni
announced	bejelentett
announcement	közlemény
annoying	bosszantó
annual	évi
annually	évente
anonymous	névtelen
another	egy másik
answer	válasz
answered	válaszolta
answers	válaszol
anterior	elülső
antibiotic	antibiotikum
antibiotics	antibiotikumok
antibodies	antitestek
antibody	ellenanyag
anxiety	szorongás
any	Bármi
anymore	többé
anyone	bárki
anything	bármi
anyway	akárhogyan is
anywhere	bárhol
apart	egymástól
apartment	lakás
apartments	apartmanok
apologize	bocsánatot kér
app	kb
apparatus	berendezés
apparent	látszólagos
apparently	látszólag
appeal	fellebbezés
appeals	fellebbezéseket
appear	megjelenik
appearance	kinézet
appearances	megjelenések
appeared	megjelent
appearing	megjelenő
appears	Megjelenik
appetite	étvágy
apple	alma
apples	alma
applicable	alkalmazható
application	Alkalmazás
applications	alkalmazások
applied	alkalmazott
applies	vonatkozik
apply	alkalmaz
applying	jelentkezését
appointed	kijelölt
appointment	időpont egyeztetés
appreciate	méltányol
appreciated	értékelt, megbecsült
approach	megközelítés
approached	közeledett
approaches	megközelít
approaching	közeledik
appropriate	megfelelő
approval	jóváhagyás
approve	jóváhagy
approved	jóváhagyott
approximately	hozzávetőlegesen
apps	alkalmazásokat
april	április
aquarium	akvárium
aquatic	vízi
arabia	Arábia
arabic	arab
arc	ív
arcade	árkád
arch	boltív
archaeological	régészeti
archbishop	érsek
architect	építészmérnök
architects	építészek
architectural	építészeti
architecture	építészet
archive	archívum
archives	levéltár
arctic	sarkvidéki
are	vannak
area	terület
areas	területeken
arena	aréna
arenas	arénák
Argentina	Argentína
Argentine	argentin
argue	vitatkozni
argued	érvelt
argues	azzal érvel
arguing	vitatkozik
argument	érv
arguments	érvek
arise	felmerülhet
arises	felmerül
arm	kar
armed	fegyveres
armenia	Örményország
Armenian	örmény
armies	hadseregek
armor	páncél
armored	páncélozott
arms	fegyver
army	hadsereg
aromatic	aromás
around	körül
arrange	rendezni
arranged	elrendezve
arrangement	elrendezés
arrangements	megállapodások
array	sor
arrest	letartóztatás
arrested	letartóztatott
arrival	érkezés
arrive	megérkezik
arrived	megérkezett
arrives	érkezik
arriving	érkező
arrogant	arrogáns
arrow	nyíl
arsenal	arzenál
art	Művészet
arteries	artériák
artery	artéria
arthritis	ízületi gyulladás
article	cikk
articles	cikkeket
artificial	mesterséges
artillery	tüzérségi
artist	művész
artistic	művészeti
artists	művészek
arts	művészetek
artwork	alkotás
as	mint
ash	hamu
ashamed	megszégyenülve
ashes	hamu
asia	Ázsia
asian	ázsiai
aside	félre
ask	kérdez
asked	kérdezte
asking	kérve
asks	kérdi
asleep	Alva
aspect	vonatkozás
aspects	szempontokat
assault	támadás
assembled	összeszerelve
assembly	összeszerelés
assess	felmérni
assessed	értékelték
assessment	értékelés
asset	eszköz
assets	eszközök
assigned	kijelölt
assignment	feladat
assist	segít
assistance	támogatás
assistant	helyettes
assisted	segített
associate	munkatárs
associated	társult
associates	munkatársai
association	Egyesület
associations	egyesületek
assume	feltételezni
assumed	feltételezte
assumption	feltevés
assumptions	feltételezések
asthma	asztma
asylum	bolondok háza
at	nál nél
ate	evett
Athens	Athén
athlete	sportoló
athletes	sportolók
athletic	atlétikai
athletics	atlétika
atlantic	atlanti
atmosphere	légkör
atmospheric	légköri
atomic	atom
atoms	atomok
attach	csatolni
attached	csatolt
attachment	mellékletet
attack	támadás
attacked	megtámadták
attacking	támadó
attacks	támadások
attempt	kísérlet
attempted	megkísérelte
attempting	megkísérelve
attempts	próbálkozások
attend	részt vesz
attended	részt vett
attending	részt vesz
attention	Figyelem
attitude	hozzáállás
attitudes	attitűdök
attorney	ügyvéd
attract	vonz
attracted	vonzott
attraction	vonzerő
attractions	látnivalók
attractive	vonzó
attracts	vonzza
attributed	tulajdonított
attributes	attribútumokat
auction	árverés
audience	közönség
audiences	közönség
audio	hang
august	augusztus
aunt	néni
australia	Ausztrália
australian	ausztrál
austria	Ausztria
Austrian	osztrák
authentic	hiteles
author	szerző
authorities	hatóság
authority	hatóság
authorized	felhatalmazott
authors	szerzői
auto	kocsi
automated	automatizált
automatic	automatikus
automatically	automatikusan
automation	automatizálás
automobile	autó
automotive	autóipari
autonomous	autonóm
autumn	ősz
auxiliary	kiegészítő
availability	elérhetőség
available	elérhető
avenue	sugárút
average	átlagos
aviation	repülés
avoid	elkerül
avoided	elkerülve
avoiding	elkerülve
awake	ébren
award	díj
awarded	díjazott
awards	díjakat
aware	tudatában van
awareness	tudatosság
away	el
axis	tengely
babies	babák
baby	baba
bachelor	agglegény
back	vissza
backed	háttal ellátott
background	háttér
backup	biztonsági mentés
bacteria	baktériumok
bacterial	bakteriális
bad	rossz
badly	rosszul
bag	táska
bags	táskák
baked	sült
baker	pék
baking	sütés
balance	egyensúly
balanced	kiegyensúlyozott
balcony	erkély
ball	labda
balloon	ballon
balls	labdák
Baltic	balti
ban	tilalom
banana	banán
band	Zenekar
bands	zenekarok
Bangladesh	Banglades
banking	banki
bankruptcy	csőd
banks	bankok
banned	kitiltva
banner	transzparens
bar	rúd
barely	alig
bark	ugat
barn	istálló
baron	báró
baroque	barokk
barracks	laktanya
barrel	hordó
barrier	akadály
barriers	akadályokat
bars	bárok
basal	bazális
base	bázis
based	alapján
basement	pince
bases	bázisok
basic	alapvető
basically	alapvetően
basin	mosdó
basis	alapján
basket	kosár
basketball	kosárlabda
bass	basszus
bat	denevér
batch	tétel
bath	fürdőkád
bathroom	fürdőszoba
batman	Denevérember
battalion	zászlóalj
batteries	akkumulátorok
battery	akkumulátor
battle	csata
battles	csaták
bay	öböl
bc	időszámításunk előtt
be	lenni
beach	strand
beaches	strandok
beam	gerenda
beams	gerendák
bean	bab
bear	medve
beard	szakáll
bearing	csapágy
bears	medvék
beast	vadállat
beat	üt
beaten	megverték
beating	verés
beautiful	gyönyörű
beauty	szépség
became	lett
because	mert
become	válik
becomes	válik
becoming	válás
bed	ágy
bedroom	hálószoba
beds	ágyak
bee	méh
beef	marhahús
been	volt
beer	sör
bees	méhek
before	előtt
beg	könyörög
began	kezdődött
begin	kezdődik
beginning	kezdet
begins	elkezdődik
begun	megkezdett
behalf	nevében
behave	viselkedik
behavior	viselkedés
behavioral	viselkedési
behaviors	viselkedések
behaviour	viselkedés
behind	mögött
beijing	Peking
being	lény
beings	lények
Belarus	Fehéroroszország
belgian	belga
belief	hit
beliefs	hiedelmek
believe	hinni
believed	hitte
believes	hisz
believing	hinni
bell	harang
belly	has
belong	tartozik
belonged	tartozott
belonging	tartozó
belongs	tartozik
beloved	szeretett
below	lent
belt	öv
bench	pad
bend	hajlít
beneath	alatt
beneficial	előnyös
benefit	haszon
benefits	előnyöket
Bengal	Bengália
benjamin	Benjámin
bent	hajlított
besides	kívül
best	legjobb
bet	tét
beta	béta
better	jobb
between	között
beyond	túl
bias	Elfogultság
bible	Biblia
biblical	bibliai
bicycle	kerékpár
bid	ajánlatot
big	nagy
bigger	nagyobb
biggest	legnagyobb
bike	bicikli
bilateral	kétoldalú
bill	számla
billboard	hirdetőtábla
billion	milliárd, ezermillió
bills	számlákat
billy	fütykösbot
bin	kuka
binary	bináris
bind	kötni
binding	kötés
biographical	életrajzi
biography	életrajz
biological	biológiai
biology	biológia
bird	madár
birds	madarak
birth	születés
birthday	születésnap
bishop	püspök
bishops	püspökök
bite	harapás
bits	bitek
bitter	keserű
black	fekete
bladder	hólyag
blade	penge
blades	pengék
blame	feddés
blamed	hibáztatták
blanket	takaró
bleeding	vérzés
blend	keverék
blessed	áldott
blew	fújt
blind	vak
block	Blokk
blockchain	blokklánc
blocked	zárolt
blocking	blokkolása
blocks	blokkok
blonde	szőke
blood	vér
bloody	véres
bloom	virágzás
blow	fúj
blowing	fúj
blown	kifulladt
blows	ütéseket
blue	kék
board	tábla
boarding	beszállás
boards	táblák
boat	hajó
boats	csónakok
bodies	testek
body	test
boil	felforraljuk
boiled	főtt
boiling	forró
bold	bátor
bomb	bomba
bombing	bombázás
bombs	bombák
bond	kötvény
bonds	kötvények
bone	csont
bones	csontok
bonus	bónusz
book	könyv
books	könyveket
boom	bumm
boost	lendületet
boots	csizma
border	határ
borders	határok
bore	furat
bored	unott
boring	unalmas
born	született
borough	kerület
borrow	kölcsönkérni
borrowed	kölcsönzött
boss	főnök
both	mindkét
bother	zavar
bottle	üveg
bottles	palackok
bottom	alsó
bought	vásárolt
bound	összekötött
boundaries	határait
boundary	határ
bourgeois	polgári
bow	íj
bowl	tál
box	doboz
boxes	dobozok
boxing	boksz
boy	fiú
boyfriend	fiú barát
boys	fiúk
brain	agy
brains	agyvelő
brake	fék
branch	ág
branches	ágak
brand	márka
branded	márkás
brands	márkák
brass	sárgaréz
brave	bátor
brazil	Brazília
brazilian	brazil
bread	kenyér
break	szünet
breakdown	bontás
breakfast	reggeli
breaking	törés
breaks	szünetek
breast	mell
breath	lehelet
breathe	lélegzik
breathing	lélegző
breed	fajta
breeding	tenyésztés
breeds	fajták
breweries	sörfőzdék
brick	tégla
bride	menyasszony
bridge	híd
bridges	hidak
brief	rövid
briefly	röviden
brigade	brigád
bright	fényes
brilliant	ragyogó
bring	hozza
bringing	hozva
brings	hoz
britain	Britannia
broad	széles
broadcast	adás
broadcasting	műsorszórás
broader	szélesebb
broke	törött
broken	törött
bronze	bronz
bros	tesók
brother	fiú testvér
brothers	testvérek
brought	hozott
brown	barna
browser	böngésző
brush	kefe
Brussels	Brüsszel
brutal	brutális
bubble	buborék
bubbles	buborékok
bucket	vödör
buddhism	buddhizmus
buddhist	buddhista
budget	költségvetés
buffalo	bivaly
bug	bogár
bugs	hibákat
build	épít
building	épület
buildings	épületek
built	épült
bulgaria	Bulgária
bulk	ömlesztett
bull	bika
bullet	golyó
bullets	golyókat
bunch	csokor
burden	teher
bureau	hivatal
burial	temetés
buried	eltemették
burn	éget
burned	égett
burning	égő
burns	égési sérüléseket
burst	robbanás
bury	temetni
bus	busz
buses	buszok
bush	bokor
business	üzleti
businesses	vállalkozásokat
businessman	üzletember
busy	elfoglalt
but	de
butter	vaj
butterfly	pillangó
button	gomb
buttons	gombokat
buy	megvesz
buyer	vevő
buyers	vásárlók
buying	vásárlás
by	által
bypass	kitérő
Byzantine	bizánci
cabin	kabin
cabinet	szekrény
cable	kábel
cables	kábelek
cafe	kávézó
cage	ketrec
cake	torta
cakes	sütemények
calcium	kalcium
calculate	kiszámítja
calculated	számított
calculation	számítás
calculations	számításokat
calendar	naptár
california	Kalifornia
call	hívás
called	hívott
calling	hívás
calls	hívásokat
calm	nyugodt
calories	kalóriát
came	jött
camel	teve
camera	kamera
cameras	kamerák
camp	tábor
campaign	kampány
campaigns	kampányok
camping	kemping
camps	táborok
campus	egyetem
can	tud
canada	Kanada
canadian	kanadai
canal	csatorna
cancel	megszünteti
canceled	törölve
cancelled	törölve
cancer	rák
candidate	jelölt
candidates	jelöltek
candle	gyertya
candles	gyertyák
candy	cukorka
cannabis	kannabisz
cannon	ágyú
cannot	nem tud
canon	kánon
canvas	vászon
canyon	kanyon
cap	sapka
capabilities	képességeit
capability	képesség
capable	képes
capacity	kapacitás
cape	köpeny
capital	főváros
capitalism	kapitalizmus
capitalist	kapitalista
caps	sapkák
capsule	kapszula
captain	kapitány
capture	elfog
captured	elfogták
carbon	szén
card	kártya
cardboard	karton
cardiac	szív-
cardinal	bíboros
cards	kártyákat
care	gondoskodás
career	karrier
careful	óvatos
carefully	gondosan
cargo	szállítmány
caribbean	karibi
carolina	karolina
carpet	szőnyeg
carriage	szállítás
carried	hordták
carrier	hordozó
carriers	szállítók
carries	hordoz
carry	visz
carrying	hordozó
cars	autók
cart	szekér
carter	kocsis
cartoon	rajzfilm
cartridge	patron
carved	faragott
case	ügy
cases	esetek
cash	készpénz
casino	kaszinó
cast	öntvény
casting	öntvény
castle	kastély
casual	alkalmi
cat	macska
catalog	katalógus
catalyst	katalizátor
catch	fogás
catching	fogása
categories	kategóriákat
category	kategória
cathedral	székesegyház
catholic	katolikus
cats	macskák
cattle	marha
caught	elkapták
cause	ok
caused	okozta
causes	okoz
causing	okozó
cavalry	lovasság
cave	barlang
caves	barlangok
cavity	üreg
ceased	megszűnt
ceiling	mennyezet
celebrate	ünnepel
celebrated	ünnepelt
celebration	ünneplés
celebrity	híres ember
cell	sejt
cells	sejteket
cellular	sejtes
celtic	kelta
cemeteries	temetők
cemetery	temető
census	népszámlálás
center	központ
centered	központosított
centers	központok
central	központi
centre	központ
centres	központok
centuries	századokban
century	század
ceo	vezérigazgató
ceramic	kerámiai
cerebral	agyi
ceremonies	szertartások
ceremony	ceremónia
certain	bizonyos
certainly	biztosan
certificate	bizonyítvány
certification	tanúsítvány
certified	igazolt
cervical	nyaki
chain	lánc
chains	láncok
chair	szék
chairman	elnök
chairs	székek
challenge	kihívás
challenged	megtámadta
challenges	kihívásokat
challenging	kihívást jelentő
chamber	kamra
chambers	kamrák
champagne	pezsgő
champion	bajnok
champions	bajnokok
championship	bajnokság
championships	bajnokságok
chance	véletlen
chancellor	kancellár
chances	esélyei
change	változás
changed	megváltozott
changes	változtatások
changing	változó
channel	csatorna
channels	csatornák
chaos	káosz
chapel	kápolna
chapter	fejezet
chapters	fejezeteket
character	karakter
characteristic	jellegzetes
characteristics	jellemzők
characterized	jellemzett
characters	karakterek
charge	díj
charged	töltött
charges	díjak
charging	töltés
charity	adomány
charles	Károly
charm	báj
charming	bájos
chart	diagram
charts	diagramok
chase	üldözés
chasing	üldöz
chassis	alváz
chat	csevegés
cheap	olcsó
cheaper	olcsóbb
check	jelölje be
checked	ellenőrizve
checking	ellenőrzése
checks	ellenőrzi
cheek	arcát
cheese	sajt
chef	séf
chemical	kémiai
chemicals	vegyszerek
chemistry	kémia
chemotherapy	kemoterápia
cherry	cseresznye
chess	sakk
chest	mellkas
chewing	rágás
chicken	csirke
chickens	csirkék
chief	fő
child	gyermek
childhood	gyermekkor
children	gyermekek
china	Kína
chinese	kínai
chip	Forgács
chips	hasábburgonya
chloride	klorid
chocolate	csokoládé
choice	választás
choices	választási lehetőségeket
choir	kórus
cholesterol	koleszterin
choose	választ
choosing	választva
chosen	választott
christ	Krisztus
christian	keresztény
Christianity	kereszténység
Christians	keresztények
christmas	Karácsony
chrome	króm
chronic	krónikus
chuck	tokmány
church	templom
churches	templomok
cigarette	cigaretta
cigarettes	cigaretta
cinema	mozi
circle	kör
circles	körökben
circuit	áramkör
circuits	áramkörök
circular	kör alakú
circulation	keringés
circumstances	körülmények
circus	cirkusz
cited	idézett
cities	városok
citizen	polgár
citizens	állampolgárok
citizenship	polgárság
city	város
civilian	polgári
civilians	civilek
civilization	civilizáció
claim	követelés
claimed	állította
claiming	azt állítva
claims	állítja
clan	klán
clarity	világosság
class	osztály
classes	osztályok
classic	klasszikus
classical	klasszikus
classification	osztályozás
classified	osztályozott
classroom	tanterem
class	osztály
clay	agyag
clean	tiszta
cleaned	tisztítani
cleaner	tisztító
cleaning	tisztítás
clear	egyértelmű
cleared	törölve
clearing	klíring
clearly	tisztán
click	kattintson
client	ügyfél
clients	ügyfelek
cliff	szikla
climate	éghajlat
climb	mászik
climbed	felmászott
climbing	mászó
clinic	klinika
clinical	klinikai
clock	óra
close	Bezárás
closed	zárva
closely	szorosan
closer	közelebb
closest	legközelebb
closet	fülke
closing	záró
closure	bezárás
cloth	szövet
clothes	ruhák
cloud	felhő
clouds	felhők
club	klub
clubs	klubok
cluster	fürt
clusters	klaszterek
coach	távolsági busz
coaches	edzők
coal	szén
coalition	koalíció
coast	tengerpart
coastal	parti
coat	kabát
coated	bevont
coating	bevonat
coconut	kókuszdió
code	kód
codes	kódokat
coding	kódolás
coffee	kávé
cognitive	kognitív
coin	érme
coins	érméket
cold	hideg
collaborated	együttműködött
collaboration	együttműködés
collapse	összeomlás
collapsed	összeesett
collar	gallér
colleague	kolléga
colleagues	kollégák
collect	gyűjt
collected	összegyűjtött
collecting	gyűjtő
collection	Gyűjtemény
collections	gyűjtemények
collective	kollektív
collector	gyűjtő
college	főiskola
colleges	főiskolák
collision	ütközés
colonel	ezredes
colonial	gyarmati
colonies	kolóniák
colony	kolónia
color	szín
colored	színezett
colorful	színes
colors	színek
colour	szín
colours	színek
columbia	Kolumbia
columbus	kolumbusz
column	oszlop
columns	oszlopok
combat	harc
combination	kombináció
combinations	kombinációk
combine	kombájn
combined	kombinált
combines	egyesíti
combining	kombinálása
combustion	égés
come	jön
comedy	komédia
comes	jön
comfort	kényelem
comfortable	kényelmes
comic	komikus
comics	képregények
coming	eljövetel
command	parancs
commanded	parancsolta
commander	parancsnok
commands	parancsokat
commenced	megkezdődött
comment	megjegyzés
comments	Hozzászólások
commerce	kereskedelem
commercial	kereskedelmi
commercially	kereskedelmileg
commission	jutalék
commissioned	megbízott
commissioner	biztos
commit	elkövetni
commitment	elkötelezettség
committed	elkötelezett
committee	bizottság
common	gyakori
commonly	általában
commons	közbirtokosság
commonwealth	Nemzetközösség
communicate	kommunikálni
communication	kommunikáció
communications	kommunikáció
communist	kommunista
community	közösség
compact	kompakt
companies	cégek
companion	társ
company	vállalat
comparable	hasonló
compare	összehasonlítani
compared	ahhoz képest
comparing	összehasonlítása
comparison	összehasonlítás
compatible	összeegyeztethető
compensation	kártérítés
compete	versenyez
competed	versenyeztek
competent	illetékes
competing	versengő
competition	verseny
competitions	versenyeken
competitive	kompetitív
competitors	versenytársak
compilation	összeállítás
compiled	összeállított
complain	panaszkodik
complained	panaszkodott
complaint	panasz
complaints	panaszok
complement	kiegészítés
completed	elkészült
completely	teljesen
completing	befejezése
completion	befejezése
complex	összetett
complexes	komplexek
complexity	bonyolultság
compliance	megfelelés
complicated	bonyolult
complications	szövődmények
comply	betartani
component	összetevő
components	alkatrészek
composed	összeállított
composer	Zeneszerző
composite	összetett
composition	fogalmazás
compositions	kompozíciók
compound	összetett
compounds	vegyületek
comprehensive	átfogó
compressed	összenyomva
compression	tömörítés
comprises	tartalmazza
comprising	amely magában foglalja
compromise	kompromisszum
computer	számítógép
computers	számítógépek
computing	számítástechnika
conceived	fogant
concentrate	sűrítmény
concentrated	sűrített
concentration	koncentráció
concentrations	koncentrációk
concept	koncepció
concepts	fogalmak
concern	vonatkozik
concerned	érintett
concerning	vonatkozó
concerns	aggodalmak
concert	koncert
concerts	koncertek
concluded	arra a következtetésre jutott
conclusion	következtetés
conclusions	következtetéseket
concrete	Konkrét
condemned	elítélt
condition	feltétel
conditioning	kondicionálás
conditions	körülmények
conduct	magatartás
conducted	végzett
conducting	vezető
cone	kúp
conference	konferencia
conferences	konferenciákon
confidence	bizalom
confident	magabiztos
configuration	konfigurációt
confirm	megerősít
confirmation	megerősítés
confirmed	megerősített
conflict	konfliktus
conflicts	konfliktusok
confuse	összezavarni
confused	zavaros
confusion	zavar
congenital	veleszületett
congress	Kongresszus
congressional	kongresszusi
conjunction	kötőszó
connect	csatlakozni
connected	csatlakoztatva
connecting	összekötő
connection	kapcsolat
connections	kapcsolatokat
connects	összeköt
conquered	meghódította
conquest	hódítás
conscience	lelkiismeret
conscious	tudatos
consciousness	öntudat
consecutive	egymást követő
consensus	konszenzus
consent	beleegyezés
consequence	következmény
consequences	következményei
conservation	Megőrzés
conservative	konzervatív
consider	fontolgat
considerable	figyelemre méltó
considerably	jelentősen
consideration	megfontolás
considered	figyelembe vett
considering	figyelembe véve
considers	úgy véli
consist	áll
consisted	állt
consistency	következetesség
consistent	következetes
consisting	álló
consists	áll
console	konzol
conspiracy	összeesküvés
constant	állandó
constantly	állandóan
constituency	választókerület
constitute	alkotják
constitution	alkotmány
constitutional	alkotmányos
construct	építeni
constructed	felépített
construction	Építkezés
consultation	konzultáció
consulting	tanácsadó
consume	fogyaszt
consumed	elfogyasztott
consumer	fogyasztó
consumers	fogyasztók
consuming	fogyasztó
consumption	fogyasztás
contact	kapcsolatba lépni
contacted	felvette a kapcsolatot
contacts	kapcsolatokat
contain	tartalmaz
contained	tartalmazott
container	tartály
containers	konténerek
containing	tartalmazó
contains	tartalmaz
contaminated	szennyezett
contamination	szennyeződés
contemporary	kortárs
content	tartalom
contents	tartalmat
contest	verseny
contested	vitatott
context	kontextus
continent	kontinens
continental	kontinentális
continuation	folytatás
continue	folytatni
continued	folytatta
continues	folytatja
continuing	folytatva
continuous	folyamatos
continuously	folyamatosan
contract	szerződés
contracted	szerződéses
contracts	szerződéseket
contrary	ellentétes
contrast	kontraszt
contribute	hozzájárul
contributed	hozzájárult
contributes	hozzájárul
contributing	hozzájárulva
contribution	hozzájárulás
contributions	hozzájárulások
control	ellenőrzés
controlled	ellenőrzött
controller	vezérlő
controlling	irányító
controls	vezérlők
controversial	vitatott
controversy	vita
convenient	kényelmes
convention	egyezmény
conventional	hagyományos
conversation	beszélgetés
conversations	beszélgetések
conversion	átalakítás
convert	alakítani
converted	átalakítva
convey	közvetíteni
convicted	elítélt
convince	meggyőzni
convinced	meggyőződve
cook	szakács
cooked	főtt
cookies	sütiket
cooking	főzés
cool	menő
cooled	lehűtött
cooling	hűtés
cooper	kádár
cooperation	együttműködés
coordinate	koordináta
coordination	koordináció
cope	megbirkózni
copies	másolatokat
copper	réz
copy	másolat
copyright	szerzői jog
coral	korall
cord	zsinór
core	mag
corn	kukorica
corner	sarok
corners	sarkok
coronavirus	koronavírus
corporate	társasági
corporation	vállalat
corporations	vállalatok
corps	hadtest
correct	helyes
correction	javítás
correctly	helyesen
correlation	korreláció
correspond	megfelelnek
corresponding	megfelelő
corresponds	megfelel
corridor	folyosó
corridor	folyosó
corrosion	korrózió
corrupt	korrupt
corruption	korrupció
cortex	kéreg
cosmetic	kozmetika
cosmic	kozmikus
cost	költség
costs	költségeket
costume	kosztüm
cottage	kunyhó
cotton	pamut
cough	köhögés
could	tudott
couldn	nem tudott
council	tanács
count	számol
counted	megszámolta
counter	számláló
counties	megyékben
counting	számolás
countless	számtalan
countries	országok
country	ország
countryside	vidéki táj
counts	számít
coup	puccs
couple	párosít
coupled	összekapcsolt
couples	párok
courage	bátorság
course	tanfolyam
courses	tanfolyamok
court	bíróság
courts	bíróságok
courtyard	udvar
cousin	unokatestvér
cousins	unokatestvérek
cover	borító
coverage	lefedettség
covered	fedett
covering	burkolat
covers	borítók
cow	tehén
cows	tehenek
crack	rés
craft	hajó
crane	daru
crash	összeomlik
crashed	lezuhant
crater	kráter
crazy	őrült
cream	krém
create	teremt
created	létre
creates	létrehozza
creating	létrehozása
creation	Teremtés
creative	kreatív
creativity	kreativitás
creator	Teremtő
creature	teremtmény
creatures	lények
credit	hitel
credited	jóváírva
credits	krediteket
creek	patak
crew	legénység
cricket	krikett
cried	kiáltott
crime	bűn
crimes	bűncselekmények
criminal	Bűnügyi
criminals	bűnözők
crisis	válság
criteria	kritériumok
critic	kritikus
critical	kritikai
criticism	kritika
criticized	kritizálta
critics	kritikusok
crop	Vág
crops	termények
cross	kereszt
crossed	keresztbe
crosses	keresztek
crossing	átkelés
crowd	tömeg
crowded	zsúfolt
crown	korona
crowned	koronás
crucial	alapvető
cruel	kegyetlen
cruise	hajókázás
crush	összetörni
crushed	összetörve
crust	kéreg
cry	kiáltás
crying	síró
crypto	kripto
crystal	kristály
crystalline	kristályos
crystals	kristályok
cuba	Kuba
Cuban	kubai
cuisine	konyha
cult	kultusz
cultivated	művelt
cultivation	termesztés
cultural	kulturális
culture	kultúra
cultures	kultúrák
cup	csésze
cups	csészéket
cure	gyógymód
cured	meggyógyult
curiosity	kíváncsiság
curious	kíváncsi
currency	valuta
current	jelenlegi
currently	jelenleg
currents	áramlatok
curse	átok
curtain	függöny
curve	ív
curved	ívelt
curves	görbék
custody	őrizet
custom	egyedi
customer	vevő
customers	vásárlók
customs	vám
cut	vágott
cute	aranyos
cuts	vágások
cutting	vágás
cycle	ciklus
cycles	ciklusok
cycling	kerékpározás
cyclone	ciklon
cylinder	henger
cyprus	Ciprus
czech	cseh
dad	apu
daily	napi
dairy	tejtermék
dam	gát
damage	kár
damaged	sérült
damaged	sérült
damages	kártérítés
damn	átkozott
dance	tánc
dancer	táncos
dances	táncol
dancing	tánc
danger	veszély
dangerous	veszélyes
danish	dán
dare	merészel
dark	sötét
darkness	sötétség
data	adat
database	adatbázis
date	dátum
dated	keltezett
dates	dátumok
dating	társkereső
daughter	lánya
daughters	lányai
dawn	hajnal
day	nap
days	napok
dead	halott
deadly	halálos
deaf	süket
deal	üzlet
dealer	kereskedő
dealing	foglalkozik
deals	ajánlatokat
dealt	foglalkozott
dean	dékán
dear	kedves
death	halál
deaths	halálozások
debate	vita
debris	törmelék
debt	adósság
debts	adósságok
debut	bemutatkozás
debuted	debütált
decade	évtized
decades	évtizedekben
decay	hanyatlás
decay	hanyatlás
deceased	elhunyt
decent	megfelelő
decide	döntsd el
decided	határozott
decides	dönt
decision	döntés
decisions	döntéseket
decisive	döntő
deck	fedélzet
declaration	nyilatkozat
declared	jelentette ki
decline	hanyatlás
declined	elutasította
decorate	díszít
decorated	díszített
decoration	dekoráció
decorative	dekoratív
decrease	csökken
decreased	csökkent
decreases	csökken
decrease	csökken
decree	rendelet
dedicated	dedikált
deep	mély
deeper	mélyebbre
deeply	mélyen
deer	szarvas
default	alapértelmezett
defeat	vereség
defeated	legyőzött
defeating	legyőzni
defect	disszidál
defects	hibákat
defence	védelem
defend	megvédeni
defended	védekezett
defending	védekező
defense	védelem
defensive	védekező
deficiency	hiány
define	meghatározni
defined	meghatározott
defines	meghatározza
defining	meghatározó
definitely	egyértelműen
definition	meghatározás
definitions	definíciók
degree	fokozat
degrees	fokon
delay	késleltetés
delayed	késleltetett
delegation	delegáció
delete	töröl
deleted	törölve
deliberately	szándékosan
delicate	törékeny
delicious	finom
deliver	szállít
delivered	szállított
delivery	szállítás
demand	igény
demanded	követelte
demanding	igényes
demands	igények
democracy	demokrácia
democrat	demokrata
democratic	demokratikus
democrats	demokraták
demolished	lebontották
demon	démon
demons	démonok
demonstrate	demonstrálni
demonstrated	igazolták
demonstrates	demonstrálja
demonstration	demonstráció
denied	tagadta
denmark	Dánia
dense	sűrű
density	sűrűség
dental	fogászati
dentist	fogorvos
department	osztály
departments	osztályok
departure	indulás
depend	függ
dependent	függő
depending	attól függően
depends	attól függ
depicted	ábrázolt
deployed	bevetve
deployment	bevetése
deposit	letét
deposited	letétbe helyezve
deposits	betétek
depressed	nyomott
depression	depresszió
depth	mélység
depths	mélységek
deputy	helyettes
derivative	derivált
derivatives	származékai
derived	származtatott
descendants	leszármazottak
descended	leereszkedett
descent	Származás
describe	leírni
described	leírta
describes	körülír
describing	leírva
description	leírás
desert	sivatag
deserve	megérdemlik
deserves	megérdemli
design	tervezés
designated	kijelölt
designation	kijelölés
designed	tervezett
designer	tervező
designers	tervezők
designing	tervezés
designs	tervez
desirable	kívánatos
desire	vágy
desired	kívánatos
desires	vágyak
desk	asztal
desktop	asztali
desperate	kétségbeesett
despite	annak ellenére
dessert	desszert
destination	rendeltetési hely
destiny	sors
destroyed	megsemmisült
destroying	pusztító
destruction	megsemmisítés
destructive	pusztító
detail	Részlet
detailed	részletes
details	részletek
detained	visszatartott
detect	felismerni
detected	észlelt
detection	érzékelés
detective	nyomozó
detention	fogva tartás
determination	meghatározás
determine	meghatározni
determined	eltökélt
determines	meghatározza
determining	meghatározó
devastating	pusztító
develop	fejleszteni
developed	fejlett
developer	fejlesztő
developers	fejlesztők
developing	fejlesztés
development	fejlesztés
developments	fejlesztéseket
develops	fejlődik
device	eszköz
devices	eszközöket
devil	ördög
devoted	elkötelezett
diabetes	cukorbetegség
diagnosed	diagnosztizálták
diagnosis	diagnózis
diagnostic	diagnosztikai
dialect	nyelvjárás
dialects	nyelvjárások
dialogue	párbeszéd
diameter	átmérő
diamond	gyémánt
diamonds	gyémántok
diary	napló
dick	Fasz
dictionary	szótár
did	tette
didn	nem
die	meghal
died	meghalt
dies	meghal
diesel	dízel
diet	diéta
dietary	étrendi
differ	különbözik
difference	különbség
differences	különbségek
different	különböző
differential	differenciális
differently	eltérően
differs	különbözik
difficulties	nehézségek
difficulty	nehézség
digestive	emésztési
digging	ásás
digit	számjegy
digital	digitális
dignity	méltóság
dimension	dimenzió
dimensional	dimenziós
dimensions	méretek
dining	étkező
dinosaurs	dinoszauruszok
diocese	egyházmegye
dioxide	dioxid
diplomatic	diplomáciai
direct	közvetlen
directed	irányította
direction	irány
directions	irányokat
directly	közvetlenül
director	rendező
directors	rendezők
dirt	piszok
dirty	piszkos
disabled	Tiltva
disappear	eltűnik
disappeared	eltűnt
disappointed	csalódott
disaster	katasztrófa
disc	lemez
discharge	kisülés
discipline	fegyelem
disciplines	diszciplínák
discontinued	megszakított
discount	kedvezmény
discover	felfedez
discovered	felfedezték
discovers	felfedezi
discovery	felfedezés
discrimination	megkülönböztetés
discs	lemezeket
discuss	megbeszélni
discussed	megbeszélték
discussing	megvitatása
discussion	vita
discussions	viták
disease	betegség
diseases	betegségek
disgusting	undorító
dish	tál
dishes	edények
Disk	Korong
dismissed	elbocsátották
disorder	rendellenesség
disorders	rendellenességek
displacement	elmozdulás
display	kijelző
displayed	Megjelenik
displays	megjeleníti
disposal	ártalmatlanítása
dispute	vita
disputed	vitatott
disputes	viták
dissolved	feloldódott
distance	távolság
distances	távolságok
distant	távoli
distinct	különböző
distinction	megkülönböztetés
distinctive	megkülönböztető
distinguish	megkülönböztetni
distinguished	kiváló
distribute	terjeszteni
distributed	megosztott
distribution	terjesztés
district	kerület
districts	kerületek
disturbed	zavart
dive	merülés
diverse	különböző
diversity	sokféleség
divide	feloszt
divided	megosztott
divine	isteni
diving	búvárkodás
division	osztály
divisions	hadosztályok
divorce	válás
divorced	elvált
dna	DNS
do	csináld
dock	dokk
doctor	orvos
doctors	orvosok
doctrine	doktrína
document	dokumentum
documentary	dokumentumfilm
documentation	dokumentáció
documented	dokumentált
documents	dokumentumokat
does	csinál
doesn	nem
dog	kutya
dogs	kutyák
doing	csinál
doll	baba
dollar	dollár
dollars	dollárt
dolphins	delfinek
domain	tartomány
dome	kupola
domestic	belföldi
dominant	uralkodó
dominate	uralni
dominated	uralta
donated	adományozott
done	Kész
door	ajtó
doors	ajtók
dose	dózis
doses	adagokat
double	kettős
doubt	kétség
doubts	kétségek
dough	tészta
down	le
download	Letöltés
downtown	belváros
dozen	tucat
dozens	több tucat
draft	tervezet
drafted	fogalmazott
drag	húzza
dragon	sárkány
dragons	sárkányok
drain	csatorna
drainage	vízelvezetés
drama	dráma
dramatic	drámai
dramatically	drámaian
drank	ivott
draw	húz
drawing	rajz
drawings	rajzokat
drawn	húzott
draws	felhívja
dream	álom
dreamed	álmodott
dreams	álmokat
dress	ruha
dressed	öltözött
dresses	ruhák
dressing	öltözködés
drew	rajzolt
dried	szárított
drill	fúró
drilling	fúrás
drink	ital
drinking	ivás
drinks	italokat
drive	hajtás
driven	hajtott
driver	sofőr
drivers	járművezetők
drives	meghajtók
driving	vezetés
drop	csepp
dropped	csökkent
drops	cseppek
drought	aszály
drove	hajtott, vezetett
drowned	megfulladt
drug	drog
drugs	drogok
drum	dob
drummer	dobos
drums	dobok
drunk	részeg
dry	száraz
drying	szárítás
dual	dupla
duck	kacsa
due	esedékes
dug	ásta
duke	herceg
dull	unalmas
duo	duó
durable	tartós
duration	időtartama
during	alatt
dust	por
dutch	holland
duties	kötelességek
duty	kötelesség
dwarf	törpe
dye	festék
dying	haldoklik
dynamic	dinamikus
dynamics	dinamika
dynasty	dinasztia
each	minden egyes
eagle	sas
eagles	sasok
ear	fül
earl	gróf
earlier	korábban
earliest	legkorábban
early	korai
earn	pénzt keres
earned	szerzett
earning	kereső
ears	fülek
earth	föld
earthquake	földrengés
ease	könnyedség
easier	könnyebb
easily	könnyen
east	keleti
easter	húsvéti
eastern	keleti
easy	könnyen
eat	eszik
eaten	evett
eating	enni
eats	eszik
ecological	ökológiai
economic	gazdasági
economics	közgazdaságtan
economies	gazdaságok
economy	gazdaság
ecosystem	ökoszisztéma
ecosystems	ökoszisztémák
ed	szerk
edge	él
edges	élek
edited	szerkesztette
editing	szerkesztés
edition	kiadás
editions	kiadások
editor	szerkesztő
editorial	szerkesztőségi
educate	oktat
educated	művelt
education	oktatás
educational	nevelési
effect	hatás
effective	hatékony
effectively	hatékonyan
effectiveness	hatékonyság
effects	hatások
efficacy	hatékonyság
efficiency	hatékonyság
efficient	hatékony
efficiently	hatékonyan
effort	erőfeszítés
efforts	erőfeszítések
egg	tojás
eggs	tojás
egypt	Egyiptom
egyptian	egyiptomi
eight	nyolc
eighteen	tizennyolc
eighth	nyolcadik
either	bármelyik
elaborate	bonyolult
elastic	rugalmas
elder	idősebb
elderly	idős
eldest	legidősebb
elect	választ
elected	megválasztott
election	választás
elections	választások
electoral	választói
electric	elektromos
electrical	elektromos
electricity	elektromosság
electromagnetic	elektromágneses
electron	elektron
electronic	elektronikus
electronics	elektronika
electrons	elektronok
elegant	elegáns
element	elem
elementary	alapvető
elements	elemeket
elephant	elefánt
elevated	emelkedett
elevation	magasság
elevator	lift
eleven	tizenegy
eligible	választható
eliminate	megszüntetni
eliminated	Eltüntetett
elimination	megszüntetése
elite	elit
elizabeth	Erzsébet
else	más
elsewhere	máshol
embarrassed	zavart
embassy	nagykövetség
embedded	beágyazott
emerge	felbukkan
emerged	előkerült
emergence	megjelenése
emergency	vészhelyzet
emerging	feltörekvő
emission	kibocsátás
emissions	kibocsátások
emotion	érzelem
emotional	érzelmi
emotions	érzelmek
emperor	császár
emphasis	hangsúly
emphasize	hangsúlyt helyez
emphasized	hangsúlyozta
empire	Birodalom
employed	munkavállaló
employee	munkavállaló
employees	alkalmazottak
employer	munkáltató
employment	foglalkoztatás
empty	üres
en	hu
enable	engedélyezze
enabled	engedélyezve van
enables	lehetővé teszi
enclosed	zárt
encounter	találkozás
encountered	találkozott
encourage	bátorítani
encouraged	biztatott
encouraging	bátorító
end	vége
endangered	veszélyeztetett
ended	vége lett
endemic	helyi
ending	befejező
endless	végtelen
endorsed	jóváhagyta
ends	véget ér
enemies	ellenségek
enemy	ellenség
energies	energiák
energy	energia
enforcement	végrehajtás
engage	vegyenek részt
engaged	elkötelezett
engagement	eljegyzés
engine	motor
engineer	mérnök
engineering	mérnöki
engineers	mérnökök
engines	motorok
england	Anglia
english	angol
enhance	fokozza
enhanced	fokozott
enjoy	Élvezd
enjoyed	élvezte
enjoying	élvezve
enjoys	élvezi
enormous	hatalmas
enough	elég
enrolled	beiratkozott
ensemble	együttes
ensure	biztosítsa
ensures	biztosítja
ensuring	biztosítva
enter	belép
entered	belépett
entering	belépő
enterprise	vállalkozás
enterprises	vállalkozások
enters	belép
entertainment	szórakozás
enthusiasm	lelkesedés
entire	teljes
entirely	teljesen
entities	entitások
entitled	jogosult
entity	entitás
entrance	bejárat
entrepreneurs	vállalkozók
entry	belépés
envelope	boríték
environment	környezet
environments	környezetek
envy	irigység
enzyme	enzim
enzymes	enzimek
epic	epikus
epidemic	járvány
episode	epizód
episodes	Epizódok
equal	egyenlő
equality	egyenlőség
equally	egyaránt
equation	egyenlet
equations	egyenletek
equilibrium	egyensúlyi
equipment	felszerelés
equipped	felszerelt
equity	saját tőke
era	korszak
erected	felállított
error	hiba
errors	hibákat
escape	menekülni
escaped	megszökött
especially	különösen
Esperanto	eszperantó
essay	esszé
essence	lényeg
essential	alapvető
essentially	lényegében
establish	létrehozni
established	alapított
establishing	létesítése
establishment	létesítése
estate	birtok
estimate	becslés
estimated	becsült
estimates	becslések
estonia	Észtország
etc	stb.
eternal	örök
ethical	etikai
ethics	etika
ethiopia	Etiópia
ethnic	etnikai
europe	Európa
european	európai
Europeans	európaiak
euros	eurót
evaluate	értékelni
evaluated	értékelték
evaluation	értékelés
eve	előestéje
even	még
evening	este
event	esemény
events	eseményeket
eventually	végül is
ever	valaha
every	minden
everyday	minden nap
everyone	mindenki
everything	minden
everywhere	mindenhol
evidence	bizonyíték
evident	nyilvánvaló
evil	gonosz
evolution	evolúció
evolutionary	evolúciós
evolved	fejlődött
ex	volt
exact	pontos
exactly	pontosan
exam	vizsga
examination	vizsgálat
examine	megvizsgálni
examined	megvizsgálták
example	példa
examples	példák
exams	vizsgák
exceed	meghaladja
exceeded	meghaladta
excellence	kiválóság
excellent	kiváló
except	kivéve
exception	kivétel
exceptional	kivételes
exceptions	kivételek
excess	többlet
excessive	túlzott
exchange	csere
excited	izgatott
excitement	izgalom
exciting	izgalmas
excluded	kizárva
exclusive	kizárólagos
exclusively	kizárólagosan
excuse	mentség
executed	végrehajtott
execution	végrehajtás
executive	végrehajtó
exercise	gyakorlat
exercises	feladatok
exhaust	kipufogó
exhausted	kimerült
exhibit	kiállítás
exhibited	kiállítva
exhibition	kiállítás
exhibits	kiállítások
exile	száműzetés
exist	létezik
existed	létezett
existence	létezés
existing	létező
exists	létezik
exit	kijárat
exotic	egzotikus
expand	kiterjed
expanded	kiterjesztett
expanding	bővülő
expansion	terjeszkedés
expect	elvárják
expectations	elvárások
expected	várt
expedition	expedíció
expelled	kiutasították
expense	költség
expenses	költségek
expensive	drága
experience	tapasztalat
experienced	tapasztalt
experiences	tapasztalatokat
experiencing	tapasztalni
experiment	kísérlet
experimental	kísérleti
experiments	kísérletek
expert	szakértő
expertise	szakvélemény
experts	szakértők
explain	megmagyarázni
explained	magyarázta
explains	magyarázza
explanation	magyarázat
exploitation	kizsákmányolás
exploration	felfedezés
explore	Fedezd fel
explored	feltárt
exploring	feltárása
explosion	robbanás
explosive	robbanó
exports	export
expose	kiteszik
exposed	kitett
exposure	kitettség
express	Expressz
expressed	kifejezve
expression	kifejezés
expressions	kifejezéseket
extend	kiterjeszt
extended	kiterjedt
extending	kiterjedő
extends	kiterjed
extension	kiterjesztés
extensive	kiterjedt
extensively	alaposan
extent	mértéke
exterior	külső
external	külső
extinct	kihalt
extinction	kihalás
extra	külön
extract	kivonat
extracted	kinyerjük
extraction	kitermelés
extraordinary	rendkívüli
extreme	szélső
extremely	rendkívül
eye	szem
eyed	szemű
eyes	szemek
fabric	szövet
fabrics	szövetek
facade	homlokzat
face	arc
faced	arccal
faces	arcok
facial	arc
facilitate	megkönnyíti
facilities	felszerelés
facility	létesítmény
facing	szemben
fact	tény
factor	tényező
factories	gyárak
factors	tényezőket
factory	gyár
facts	tények
faculty	tantestület
fail	nem sikerül
failed	nem sikerült
failing	hiányában
fails	nem sikerül
failure	kudarc
failures	kudarcok
fair	becsületes
fairly	meglehetősen
fairy	tündér
faith	hit
faithful	hűséges
fake	hamisítvány
fall	esik
fallen	elesett
falling	eső
falls	esik
false	hamis
fame	hírnév
familiar	ismerős
families	családok
family	család
famous	híres
fan	ventilátor
fans	rajongók
fantastic	fantasztikus
fantasy	fantázia
far	messze
farmer	Gazda
farmers	gazdálkodók
farming	mezőgazdasági
farms	gazdaságok
fascinating	elbűvölő
fashion	divat
fast	gyors
faster	gyorsabban
fastest	leggyorsabb
fat	zsír
fatal	halálos
fate	sors
father	apa
fathers	apák
fatigue	fáradtság
fault	hiba
favor	szívességet
favorable	kedvező
favorite	kedvenc
fear	félelem
fears	félelmek
feast	ünnep
feathers	tollak
feature	funkció
featured	kiemelt
features	jellemzők
featuring	közreműködő
february	február
fed	táplált
federal	szövetségi
federation	szövetség
fee	díj
feed	takarmány
feedback	Visszacsatolás
feeding	táplálás
feeds	táplálja
feel	érez
feeling	érzés
feelings	érzéseket
feels	érzi
fees	díjakat
feet	lábát
fell	leesett
fellow	fickó
felt	filc
female	női
females	nőstények
feminine	nőies
feminist	feminista
fence	kerítés
fermentation	erjesztés
ferry	komp
fertile	termékeny
festival	fesztivál
festivals	fesztiválok
fever	láz
few	kevés
fewer	kevesebb
fiber	rost
fibers	rostok
fiction	kitaláció
fictional	kitalált
field	terület
fields	mezőket
fifteen	tizenöt
fifth	ötödik
fifty	ötven
fight	harc
fighter	harcos
fighters	harcosok
fighting	harcoló
fights	harcok
figure	ábra
figures	figurák
file	fájlt
filed	iktatott
files	fájlokat
fill	tölt
filled	megtöltött
filling	töltő
filmed	filmezték
filming	film forgatás
films	filmeket
filter	szűrő
filters	szűrők
final	végső
finally	végül
finals	döntő
finance	pénzügy
financial	pénzügyi
financing	finanszírozás
find	megtalálja
finding	lelet
findings	megállapításait
finds	talál
fine	bírság
finger	ujj
fingers	ujjait
finish	Befejez
finished	befejezett
finishing	végső
finite	véges
finland	Finnország
finnish	finn
fire	Tűz
fired	kirúgott
fires	tüzek
firing	égetés
firm	cég
firmly	határozottan
firms	cégek
first	első
fiscal	fiskális
fish	hal
fishing	halászat
fit	elfér
fitness	fitnesz
fits	illik
fitted	szerelt
five	öt
fix	javítani
fixed	rögzített
fixing	rögzítő
flag	zászló
flags	zászlókat
flame	láng
flash	vaku
flat	lakás
flavor	aroma
fled	elmenekült
fleet	flotta
flesh	hús
flew	repült
flexibility	rugalmasság
flexible	rugalmas
flies	legyek
flight	repülési
flights	járatok
float	úszó
floating	úszó
flood	árvíz
flooded	elárasztott
flooding	árvíz
floor	padló
floors	emeletek
flora	növényvilág
floral	virágos
florence	Firenze
flour	Liszt
flow	folyam
flower	virág
flowering	virágzás
flowers	virágok
flowing	folyó
flows	folyik
flu	influenza
fluid	folyadék
fluids	folyadékok
fly	légy
flying	repülő
foam	hab
focus	fókusz
focused	összpontosított
focuses	fókuszál
focusing	összpontosítás
fog	köd
fold	hajtogatni
folded	összehajtogatva
folding	összecsukható
folk	népi
follow	kövesse
followed	követte
followers	követői
following	következő
follows	következik
food	étel
foods	élelmiszerek
fool	bolond
foot	láb
footage	felvételeket
football	futball
for	számára
forbidden	tiltott
force	Kényszerítés
forced	kényszerű
forces	erők
forcing	kényszerítve
forehead	homlok
foreign	külföldi
foreigners	külföldiek
forest	erdő
forests	erdők
forever	örökké
forget	elfelejt
forgive	megbocsát
forgiveness	megbocsátás
forgot	elfelejtette
forgotten	elfelejtett
fork	Villa
form	forma
formal	hivatalos
formally	formálisan
format	formátum
formation	képződés
formations	formációk
formats	formátumok
formed	alakított
former	korábbi
formerly	korábban
forming	alakítás
forms	formák
formula	képlet
formulated	megfogalmazva
fort	erőd
forth	tovább
fortress	erőd
fortune	szerencse
forty	negyven
forum	fórum
forward	előre
fossil	kövület
fossils	kövületek
foster	nevelődjön
fought	harcolt
found	megtalált
foundation	Alapítvány
foundations	alapok
founded	alapított
founder	alapító
founders	alapítói
founding	alapítása
fountain	szökőkút
four	négy
fourteen	tizennégy
fourth	negyedik
fox	róka
fraction	töredék
fracture	törés
fragile	törékeny
fragments	töredékek
frame	keret
framed	keretezett
frames	keretek
framework	keretrendszer
france	Franciaország
frank	őszinte
fraud	csalás
frederick	Frigyes
free	ingyenes
freedom	szabadság
freely	szabadon
freeze	fagy
freezing	fagyasztó
freight	teherszállítás
french	Francia
frequencies	frekvenciák
frequency	frekvencia
frequent	gyakori
frequently	gyakran
fresh	friss
freshly	frissen
freshwater	édesvízi
friction	súrlódás
friday	péntek
fridge	hűtőszekrény
fried	sült
friend	barátja
friendly	barátságos
friends	barátok
friendship	barátság
frog	béka
from	tól től
front	elülső
frost	fagy
frozen	fagyott
fruit	gyümölcs
fruits	gyümölcsök
fry	süt
fuck	bassza meg
fuel	üzemanyag
fulfill	teljesíteni
full	teljes
fully	teljesen
fun	szórakoztató
function	funkció
functional	funkcionális
functionality	funkcionalitás
functioning	működőképes
functions	funkciókat
fund	alap
fundamental	alapvető
funded	finanszírozott
funding	finanszírozás
funds	alapok
funeral	temetés
fungi	gombák
fungus	gomba
funny	vicces
fur	szőrme
furniture	bútor
further	további
furthermore	továbbá
fusion	fúzió
future	jövő
gain	nyereség
gained	szerzett
gaining	megszerzése
gains	nyereséget
galaxy	galaxis
gallery	Képtár
gambling	szerencsejáték
game	játszma, meccs
gameplay	játékmenet
games	játékok
gaming	szerencsejáték
gang	banda
gap	rés
garage	garázs
garbage	szemét
garden	kert
gardens	kertek
garlic	fokhagyma
gas	gáz
gases	gázok
gasoline	benzin
gate	kapu
gates	kapuk
gather	összegyűjteni
gathered	összegyűjtött
gathering	összejövetel
gauge	nyomtáv
gave	adott
gay	meleg
gear	felszerelés
gel	gél
gender	neme
gene	gén
genera	nemzetségek
general	Tábornok
generally	általában
generate	generál
generated	generált
generates	generál
generating	generáló
generation	generáció
generations	generációk
generator	generátor
generic	generikus
generous	nagylelkű
genes	gének
genetic	genetikai
geneva	Genf
genius	zseni
genome	genom
genre	műfaj
genres	műfajok
gentle	kedves
gentleman	úriember
gentlemen	Urak
gently	gyengéden
genuine	őszinte
genus	nemzetség
geographic	földrajzi
geographical	földrajzi
geography	földrajz
geological	geológiai
geometric	geometriai
geometry	geometria
George	György
Georgia	Grúzia
Georgian	grúz
German	német
Germanic	germán
germans	németek
germany	Németország
get	kap
gets	kap
getting	szerzés
ghost	szellem
ghosts	szellemek
giant	óriás
giants	óriások
gift	ajándék
gifts	ajándékokat
girl	lány
girlfriend	barátnő
girls	lányok
give	adni
given	adott
gives	ad
giving	adva
glad	boldog
gland	mirigy
glands	mirigyek
glass	üveg
glasses	szemüveg
global	globális
globally	globálisan
globe	földgolyó
glory	dicsőség
gloves	kesztyűt
glucose	szőlőcukor
glue	ragasztó
go	megy
goal	cél
goals	célokat
goat	kecske
god	Isten
goddess	istennő
gods	istenek
goes	megy
going	haladó
gold	Arany
golden	aranysárga
gone	elmúlt
good	jó
goodbye	viszontlátásra
goods	áruk
gospel	evangélium
got	kapott
gothic	gótikus
gotten	kapott
governance	kormányzás
governed	kormányozzák
governing	irányító
government	kormány
governments	kormányok
governor	kormányzó
grab	Megragad
grabbed	megragadta
grace	kegyelem
grade	fokozat
grades	évfolyamok
gradual	fokozatos
gradually	fokozatosan
graduate	érettségizni
graduated	végzett
graduating	végzős
graduation	érettségi
grain	gabona
grains	gabonafélék
grammar	nyelvtan
grand	nagy
grandfather	nagyapa
grandmother	nagymama
grandson	unokája
granite	gránit
grant	támogatást
granted	megadott
grants	támogatások
grape	szőlő
grapes	szőlő
graph	grafikon
graphic	grafikus
graphics	grafika
grass	fű
grateful	hálás
grave	sír
graves	sírok
gravity	gravitáció
gray	szürke
great	nagy
greater	nagyobb
greatest	legnagyobb
greatly	nagymértékben
Greece	Görögország
Greek	görög
greeks	görögök
green	zöld
greenhouse	üvegház
greeted	üdvözölte
grew	nőtt
grey	szürke
grid	rács
grinding	őrlés
grip	markolat
gross	bruttó
ground	talaj
grounds	okokból
group	csoport
groups	csoportok
grove	liget
grow	nő
growing	növekvő
grown	felnőtt
grows	nő
growth	növekedés
guarantee	garancia
guaranteed	garantált
guarantees	garanciákat
guard	őr
guardian	gyám
guards	gárdisták
guess	Találd ki
guest	vendég
guests	vendégek
guidance	tanácsadás
guide	útmutató
guided	vezetett
guidelines	iránymutatásokat
guides	útmutatók
guilt	bűnösség
guilty	bűnös
guitar	gitár
guitarist	gitáros
gulf	öböl
gum	Gumi
gun	pisztoly
guns	fegyvereket
guy	fickó
guys	srácok
gym	tornaterem
gyms	edzőtermek
habit	szokás
habitat	élőhely
habitats	élőhelyek
habits	szokások
had	volt
hadn	volt
hair	haj
haired	hajú
half	fél
hall	előszoba
halls	termek
ham	sonka
hammer	kalapács
hand	kéz
handed	átnyújtotta
handle	fogantyú
handled	kezelt
handles	fogantyúk
handling	kezelése
hands	kezek
handsome	jóképű
hang	lóg
hanging	függő
happen	történik
happened	történt
happening	esemény
happens	történik
happiness	boldogság
happy	boldog
harbor	kikötő
harbour	kikötő
hard	kemény
harder	keményebb
hardly	alig
hardware	hardver
harm	sérelem
harmful	káros
harmony	harmónia
harsh	durva
harvest	aratás
has	van
hat	kalap
hate	gyűlöl
hated	gyűlölt
hates	gyűlöl
hatred	gyűlölet
have	van
haven	menedéket
having	amelynek
he	ő
head	fej
headache	fejfájás
headed	fejes
heading	cím
headquartered	székhelye
headquarters	központ
heads	fejek
heal	gyógyít
healing	gyógyulás
health	Egészség
healthcare	egészségügyi ellátás
healthy	egészséges
hear	hall
heard	hallott
hearing	meghallgatás
heart	szív
hearts	szívek
heat	hőség
heated	fűtött
heating	fűtés
heaven	menny
heavily	súlyosan
heavy	nehéz
hebrew	héber
height	magasság
heights	Magasság
heir	örökös
held	tartott
helicopter	helikopter
hell	pokol
Hello	Helló
helmet	sisak
help	Segítség
helped	segített
helpful	hasznos
helping	segítve
helps	segít
hemisphere	félteke
hence	ennélfogva
henry	Henrik
her	neki
herbal	gyógynövényes
herbs	gyógynövények
herd	csorda
here	itt
hereditary	örökletes
heritage	örökség
hero	hős
heroes	hősök
herself	önmaga
hey	Hé
hid	elrejtette
hidden	rejtett
hiding	bujkál
hierarchy	hierarchia
high	magas
higher	magasabb
highest	legmagasabb
highlight	Kiemel
highlighted	kiemelt
highlights	kiemeli
highly	magasan
highway	országút
highways	autópályák
hiking	túrázás
hill	hegy
hills	dombok
him	neki
himself	önmaga
hip	csípő
hire	bérel
hired	bérelt
his	övé
historian	történész
historians	történészek
historic	történelmi
historical	történelmi
historically	történelmileg
history	történelem
hit	találat
hits	találatokat
hitting	ütés
hobby	hobbi
hockey	jégkorong
hold	tart
holder	tartó
holdings	gazdaságok
holds	tart
hole	lyuk
holes	lyukakat
holiday	ünnep
holidays	ünnepek
holland	Hollandia
hollow	üreges
holy	szent
home	itthon
homeland	haza
homeless	hajléktalan
homemade	házi
homes	otthonok
hometown	szülőváros
homework	házi feladat
honest	becsületes
honey	édesem
honor	becsület
honorary	tiszteletbeli
honored	megbecsült
honour	becsület
hood	kapucni
hook	horog
hop	komló
hope	remény
hoped	remélte
hopes	reméli
hoping	remélve
horizon	horizont
horizontal	vízszintes
hormone	hormon
hormones	hormonok
horn	kürt
horror	borzalom
horse	ló
horses	lovak
hospital	kórház
hospitals	kórházak
host	házigazda
hosted	házigazdája
hostile	ellenséges
hosts	otthont ad
hot	forró
hotel	szálloda
hotels	szállodák
hour	óra
hours	órák
house	ház
housed	elhelyezett
household	háztartás
households	háztartások
houses	házak
housing	ház
how	hogyan
however	azonban
hub	kerékagy
hug	Ölelés
huge	hatalmas
hull	hajótest
human	emberi
humanitarian	humanitárius
humanity	emberiség
humans	emberek
humble	alázatos
humidity	páratartalom
hundred	száz
hundreds	több száz
hung	lógott
hungarian	Magyar
hungary	Magyarország
hunger	éhség
hungry	éhes
hunt	vadászat
hunter	vadász
hunters	vadászok
hunting	vadászat
hurry	siet
hurt	sért
hurts	fáj
husband	férj
hybrid	hibrid
hydraulic	hidraulikus
hydrogen	hidrogén
hygiene	higiénia
hypothesis	hipotézis
I	én
ice	jég
iceland	Izland
icon	ikon
idea	ötlet
ideal	ideál
ideas	ötleteket
identical	azonos
identification	azonosítás
identified	azonosított
identify	azonosítani
identifying	azonosítása
identity	identitás
ideological	ideológiai
ideology	ideológia
idiot	idióta
if	ha
ignorance	tudatlanság
ignore	figyelmen kívül hagyni
ignored	figyelmen kívül hagyva
ill	beteg
illegal	illegális
illness	betegség
illuminated	megvilágítva
illusion	illúzió
illustrated	illusztrált
image	kép
images	képeket
imagination	képzelet
imagine	Képzeld el
imagined	elképzelte
imaging	képalkotás
immediate	azonnali
immediately	azonnal
immigrants	bevándorlók
immigration	bevándorlás
immune	immunis
immunity	immunitás
impact	hatás
impacts	hatások
imperial	császári
implement	végrehajtani
implementation	végrehajtás
implemented	végrehajtva
implementing	megvalósítása
implications	következményei
implies	arra utal
importance	fontosságát
important	fontos
imported	importált
impose	előírni
imposed	kiszabott
impossible	lehetetlen
impressed	lenyűgözött
impressive	hatásos
imprisoned	bebörtönzött
imprisonment	bebörtönzés
improve	javítani
improved	javított
improvement	javulás
improvements	fejlesztések
improves	javítja
improving	javuló
in	ban ben
inaugural	beiktatása
inch	hüvelyk
incidence	előfordulása
incident	incidens
incidents	események
include	tartalmazza
included	beleértve
includes	magába foglalja
including	beleértve
inclusion	befogadás
income	jövedelem
incomplete	befejezetlen
incorporate	beépíteni
incorporated	bejegyzett
incorrect	helytelen
increase	növekedés
increased	megnövekedett
increases	növeli
increasing	növekvő
increasingly	egyre inkább
incredible	hihetetlen
incredibly	hihetetlenül
incumbent	hivatalban lévő
indeed	valóban
independence	függetlenség
independent	független
independently	függetlenül
Indian	indián
indians	indiánok
indicate	jelezze
indicated	jelzett
indicates	azt jelzi
indication	jelzés
indicator	indikátor
indicators	mutatók
indigenous	bennszülött
indirect	közvetett
individual	Egyedi
individually	egyénileg
individuals	magánszemélyek
indonesia	Indonézia
indonesian	indonéz
indoor	beltéri
induce	indukál
induced	indukált
inducted	beiktatták
induction	indukció
industrial	ipari
industries	iparágak
industry	ipar
inevitable	elkerülhetetlen
infantry	gyalogság
infected	fertőzött
infection	fertőzés
infections	fertőzések
infectious	fertőző
inferior	alsóbbrendű
infinite	végtelen
inflammatory	gyulladásos
inflation	infláció
influence	befolyás
influenced	befolyásolta
influences	befolyásolja
influential	befolyásos
inform	tájékoztatni
informal	informális
information	információ
informed	tájékozott
infrared	infravörös
infrastructure	infrastruktúra
ingredient	hozzávaló
ingredients	összetevőket
inhabitants	lakosok
inhabited	lakott
inherent	velejárója
inheritance	öröklés
inherited	örökölt
inhibitors	inhibitorok
initial	a kezdeti
initially	alapvetően
initiated	kezdeményezett
initiative	kezdeményezés
initiatives	kezdeményezések
injected	befecskendezve
injection	injekció
injured	sérült
injuries	sérülések
injury	sérülés
ink	tinta
inn	fogadó
inner	belső
innocent	ártatlan
innovation	innováció
innovations	innovációk
innovative	újító
input	bemenet
insect	rovar
insects	rovarok
insert	betét
inserted	behelyezve
inside	belül
insight	betekintést
insisted	ragaszkodott hozzá
inspection	ellenőrzés
inspiration	ihlet
inspired	ihletett
install	telepítés
installation	telepítés
installations	installációk
installed	telepítve
instance	példa
instances	esetek
instant	azonnali
instantly	azonnal
instead	helyette
institute	intézet
institution	intézmény
institutional	intézményi
institutions	intézmények
instruction	utasítás
instructions	utasítás
instrument	hangszer
instrumental	hangszeres
instruments	hangszerek
insufficient	elégtelen
insulation	szigetelés
insulin	inzulin
insurance	biztosítás
intact	ép
intake	bevitel
integral	integrál
integrate	egyesít
integrated	integrált
integration	integráció
integrity	sértetlenség
intellectual	szellemi
intelligence	intelligencia
intelligent	intelligens
intend	szándékozik
intended	szándékolt
intense	erős
intensity	intenzitás
intensive	intenzív
intent	elszánt
intention	szándék
intentions	szándékait
interact	egymásra hat
interaction	kölcsönhatás
interactions	interakciók
interactive	interaktív
interested	érdekelt
interesting	érdekes
interests	érdekeit
interface	felület
interfere	beavatkozni
interference	interferencia
interior	belső
intermediate	közbülső
internal	belső
international	nemzetközi
internationally	nemzetközileg
interpretation	értelmezés
interpreted	értelmezni
interrupted	megszakított
intersection	útkereszteződés
interval	intervallum
intervals	időközönként
intervention	közbelépés
interventions	beavatkozások
interview	interjú
interviewed	interjút készített
interviews	interjúk
intestinal	bél-
intimate	meghitt
into	-ba
introduce	bemutatni
introduced	bemutatott
introduces	bemutatja
introducing	bemutatása
introduction	bevezetés
invaded	megszállta
invasion	invázió
invasive	invazív
invented	feltalált
invention	találmány
inventory	leltár
invest	befektetni
investigate	vizsgálja meg
investigated	kivizsgálták
investigating	nyomoz
investigation	vizsgálat
investigations	vizsgálatok
investments	beruházások
investor	befektető
investors	befektetők
invisible	láthatatlan
invitation	meghívás
invite	meghív
invited	meghívott
involve	bevonni
involved	magában foglal
involvement	bevonása
involves	magában foglalja
involving	bevonásával
ions	ionok
iran	irán
iraq	Irak
ireland	Írország
irish	ír
iron	Vas
irregular	szabálytalan
irrigation	öntözés
is	van
islam	iszlám
islamic	iszlám
island	sziget
islands	szigetek
isolated	izolált
isolation	elkülönítés
israel	Izrael
Israeli	izraeli
issue	probléma
issued	kiadott
issues	problémák
istanbul	Isztambul
it	azt
italian	olasz
italy	Olaszország
item	tétel
items	tételeket
its	annak
itself	maga
jacket	dzseki
jacob	Jákób
jail	börtön
jam	lekvár
january	január
japan	Japán
japanese	japán
java	Jáva
jaw	állkapocs
jay	szajkó
jazz	dzsessz
jealous	irigy
jean	farmer
jeans	Farmer
jersey	mez
jerusalem	Jeruzsálem
jesus	Jézus
jet	vadászgép
jewelry	ékszerek
jewish	zsidó
jews	zsidók
job	munka
jobs	munkahelyek
john	János
join	csatlakozik
joined	csatlakozott
joining	csatlakozás
joint	közös
joints	ízületek
joke	tréfa
jokes	vicceket
jordan	Jordánia
joseph	József
journal	folyóirat
journalism	újságírás
journalist	újságíró
journalists	újságírók
journey	utazás
joy	öröm
judge	bíró
judges	bírák
judgment	ítélet
judicial	bírósági
juice	gyümölcslé
July	július
jump	ugrás
jumped	ugrott
junction	csomópont
june	június
jungle	dzsungel
jurisdiction	joghatóság
jury	zsűri
just	éppen
justice	igazságszolgáltatás
justify	igazolni
kazakhstan	kazahsztán
keep	tart
keeping	tartása
keeps	megtartja
kept	tartotta
key	kulcs
keyboard	billentyűzet
keys	kulcsok
khan	kán
kick	rúgás
kid	kölyök
kidnapped	elrabolták
kidney	vese
kids	gyerekek
kill	megöl
killed	megölték
killer	gyilkos
killing	gyilkolás
kills	megöl
kilometers	kilométerre
kind	kedves
kindness	kedvesség
kinds	fajtái
king	király
kingdom	királyság
kings	királyok
kiss	csók
kissed	megcsókolt
kissing	csókolózás
kit	készlet
kitchen	konyha
knee	térd
knees	térdre
knew	tudta
knife	kés
knight	lovag
knights	lovagok
knives	kések
knock	kopogás
knocked	kopogtatott
know	tud
knowing	tudván
knowledge	tudás
known	ismert
knows	tudja
korean	koreai
Kyoto	Kiotó
lab	labor
label	címke
labels	címkéket
labor	munkaerő
laboratories	laboratóriumok
laboratory	laboratórium
labour	munkaerő
lace	csipke
lack	hiánya
lacks	hiányzik
ladder	létra
ladies	hölgyek
lady	hölgy
laid	terített
lake	tó
lakes	tavak
lamb	Bárány
lamp	lámpa
lamps	lámpák
land	föld
landed	leszállt
landing	leszállás
landmark	tájékozódási pont
lands	földeket
landscape	tájkép
landscapes	tájak
lane	sáv
language	nyelv
languages	nyelvek
lap	körben
large	nagy
largely	nagymértékben
larger	nagyobb
largest	legnagyobb
larvae	lárvák
laser	lézer
last	utolsó
lasted	tartott
lasting	tartós
lasts	tart
late	késő
lately	utóbbi időben
later	a későbbiekben
lateral	oldalsó
latest	legújabb
latter	utóbbi
lattice	rács
latvia	Lettország
laugh	nevetés
laughed	nevetett
laughing	nevetés
laughter	nevetés
launch	dob
launched	elindított
laundry	mosoda
lava	láva
law	törvény
lawn	gyep
laws	törvényeket
lawsuit	per
lawyer	jogász
lawyers	ügyvédek
lay	világi
layer	réteg
layers	rétegek
laying	lefektetés
layout	elrendezés
lazy	lusta
lead	vezet
leader	vezető
leaders	vezetők
leadership	vezetés
leading	vezető
leads	vezet
leaf	levél növényen
league	liga
lean	sovány
learn	tanul
learned	tanult
learning	tanulás
learns	tanul
least	legkevésbé
leather	Bőr
leave	elhagy
leaves	levelek
leaving	kilépő
lebanon	Libanon
lecture	előadás
lectures	előadások
led	vezette
left	bal
leg	láb
legacy	örökség
legal	jogi
legally	legálisan
legend	legenda
legendary	legendás
legends	legendák
legislation	jogszabályokat
legislative	törvényhozó
legislature	törvényhozás
legitimate	jogos
legs	lábak
leisure	szabadidő
lemon	citrom
lend	kölcsönöz
length	hossz
lens	lencse
lenses	lencsék
leo	Oroszlán
lesions	elváltozások
less	Kevésbé
lesser	kevesebb
lesson	lecke
lessons	leckéket
let	hagyja
letter	levél
letters	leveleket
letting	bérbeadása
level	szint
levels	szinteket
levy	illeték
liability	felelősség
liberal	liberális
liberation	felszabadulás
liberty	szabadság
libraries	könyvtárak
library	könyvtár
libya	Líbia
license	engedély
licensed	engedélyezett
lie	fekszik
lied	hazudott
lies	hazugságok
lieutenant	hadnagy
life	élet
lifestyle	életmód
lifetime	élettartam
lift	emel
lifting	emelés
light	fény
lighter	öngyújtó
lighting	világítás
lightly	könnyen
lightning	villám
lights	Lámpák
lightweight	könnyűsúlyú
like	mint
liked	tetszett
likely	valószínűleg
likes	kedveli
lime	mész
limestone	mészkő
limit	határ
limitations	korlátozások
limited	korlátozott
limiting	korlátozó
limits	határait
line	vonal
linear	lineáris
lined	bélelt
lines	vonalak
linguistic	nyelvi
lining	bélés
linked	linkelve
links	linkeket
lion	oroszlán
lions	nevezetességek
lip	ajak
lips	ajkak
liquid	folyékony
liquids	folyadékok
list	lista
listed	listázott
listen	hallgat
listened	hallgatott
listening	hallgat
lists	listákon
lit	megvilágított
literally	szó szerint
literary	irodalmi
literature	irodalom
lithium	lítium
lithuania	Litvánia
little	kis
live	élő
lived	élt
lively	élénk
liver	máj
lives	él
livestock	állatállomány
living	élő
load	Betöltés
loaded	töltött
loading	Betöltés
loads	terhelések
loan	hitel
loans	kölcsönök
local	helyi
locally	helyileg
locals	helyiek
locate	keresse meg
location	elhelyezkedés
locations	helyszíneken
lock	zár
locked	zárt
lodge	házikó
logic	logika
logical	logikus
logistics	logisztika
logo	logó
lonely	magányos
long	hosszú
longer	hosszabb
longest	leghosszabb
look	néz
looked	nézett
looking	keres
looks	úgy néz ki
loop	hurok
loose	laza
lords	urak
lose	elveszít
loses	veszít
losing	vesztes
loss	veszteség
losses	veszteség
lost	elveszett
lot	sok
lots	sok
lottery	lottó
loud	hangos
love	szerelem
loved	szeretett
lovely	bájos
lover	szerető
lovers	szerelmesek
loves	szeret
loving	szerető
low	alacsony
lower	Alsó
lowered	leeresztett
lowest	legalacsonyabb
loyal	hűséges
loyalty	hűség
ltd	kft
luck	szerencse
lucky	szerencsés
luggage	poggyász
lunar	hold
lunch	ebéd
lung	tüdő
lungs	tüdő
luxurious	fényűző
luxury	luxus
lying	fekvő
lyrics	dalszöveg
machine	gép
machinery	gépezet
machines	gépek
macro	makró
mad	őrült
made	készült
magazine	magazin
magazines	folyóiratok
magic	varázslat
magical	mágikus
magnesium	magnézium
magnetic	mágneses
magnificent	Káprázatos
magnitude	nagyságrendű
main	fő
mainland	szárazföld
mainly	főként
maintain	fenntartani
maintained	fenntartott
maintaining	fenntartása
maintains	fenntartja
maintenance	karbantartás
major	Jelentősebb
majority	többség
make	készítsenek
maker	készítő
makers	készítők
makes	teszi
makeup	smink
making	készítése
male	férfi
males	hímek
malignant	rosszindulatú
mall	pláza
malta	Málta
mammals	emlősök
man	Férfi
manage	kezelni
managed	sikerült
management	menedzsment
manager	menedzser
manages	kezeli
managing	irányító
mandate	megbízás
mandatory	kötelező
manifestations	megnyilvánulásai
mankind	emberiség
manner	módon
manor	kastély
mansion	kastély
manual	kézikönyv
manually	manuálisan
manufacture	gyártás
manufactured	gyártott
manufacturer	gyártó
manufacturers	gyártók
manufacturing	gyártás
manuscript	kézirat
many	sok
map	térkép
mapping	feltérképezése
maps	térképek
marathon	maraton
marble	üveggolyó
march	március
margin	árrés
marine	tengeri
maritime	tengeri
marked	megjelölt
markers	markerek
market	piac
marketed	forgalomba hozott
markets	piacokon
marking	jelzés
marks	jelek
marriage	házasság
married	házas
marry	feleségül vesz
martial	harcias
martin	Márton
marvel	csoda
masks	maszkok
mass	tömeg
massacre	mészárlás
massage	masszázs
masses	tömegek
massive	tömeges
master	fő
masters	mesterek
match	mérkőzés
matches	mérkőzések
matching	illesztése
mate	társ
material	anyag
materials	anyagokat
maternal	anyai
math	matematika
mathematical	matematikai
mathematics	matematika
matrix	mátrix
matter	ügy
matters	számít
mature	érett
mausoleums	mauzóleumok
maximum	maximális
may	lehet
maybe	talán
mayor	polgármester
me	nekem
meal	étkezés
meals	étkezések
mean	átlagos
meaning	jelentése
meaningful	jelentőségteljes
meanings	jelentések
means	eszközök
meant	jelentett
meantime	közben
meanwhile	közben
measure	intézkedés
measured	mért
measurement	mérés
measurements	mérések
measures	intézkedéseket
measuring	mérő
meat	hús
mechanical	mechanikai
mechanics	mechanika
mechanism	gépezet
mechanisms	mechanizmusok
medal	érem
medals	érmeket
media	média
median	középső
medical	orvosi
medication	gyógyszer
medications	gyógyszereket
medicinal	gyógyászati
medicine	gyógyszer
medicines	gyógyszerek
medieval	középkori
meditation	elmélkedés
mediterranean	mediterrán
medium	közepes
meet	találkozik
meeting	találkozó
meetings	találkozók
meets	találkozik
melody	dallam
melt	olvad
melted	olvasztott
melting	olvasztó
member	tag
members	tagjai
membership	tagság
membrane	membrán
membranes	membránok
memorial	emlékmű
memories	emlékek
men	férfiak
mental	szellemi
mentally	mentálisan
mention	említés
mentioned	említett
menu	menü
merchant	kereskedő
merchants	kereskedők
mercury	higany
mere	puszta
merge	összeolvad
merged	összeolvadt
merger	egyesülés
mesh	háló
mess	rendetlenség
message	üzenet
messages	üzenetek
met	találkozott
metabolic	metabolikus
metabolism	anyagcsere
metal	fém
metallic	fémes
metals	fémek
meter	méter
meters	méter
method	módszer
methodology	módszertan
methods	mód
metres	méter
metro	metró
metropolitan	nagyvárosi
mexican	mexikói
mexico	Mexikó
mice	egerek
micro	mikro
microorganisms	mikroorganizmusok
mid	középső
middle	középső
midnight	éjfél
might	esetleg
migration	migráció
mike	mikrofon
milan	Milánó
mild	enyhe
mile	mérföld
miles	mérföldre
military	katonai
milk	tej
mill	malom
millennium	évezred
miller	molnár
million	millió
millions	milliókat
mills	malmok
mind	ész
minded	gondolkodó
minds	elméket
mine	enyém
mineral	ásványi
minerals	ásványok
mines	bányák
minimal	minimális
minimize	minimalizálni
minimum	minimális
mining	bányászati
minister	miniszter
ministers	miniszterek
ministry	minisztérium
minor	kiskorú
minority	kisebbség
mint	menta
minute	perc
minutes	percek
miracle	csoda
mirror	tükör
miss	hiányzik
missed	nem fogadott
missile	rakéta
missiles	rakéták
missing	hiányzó
mission	küldetés
missions	küldetések
mistake	hiba
mistakes	hibákat
mix	keverd össze
mixed	vegyes
mixing	keverés
mixture	keverék
mobile	Mobil
mobility	mobilitás
mode	mód
model	modell
modeling	modellezés
models	modellek
moderate	mérsékelt
modes	módok
modest	szerény
modification	módosítás
modifications	módosítások
modified	módosított
modify	módosít
modular	moduláris
module	modul
modules	modulok
moisture	nedvesség
mold	öntőforma
molecular	molekuláris
molecule	molekula
molecules	molekulák
mom	anya
moment	pillanat
moments	pillanatok
momentum	lendület
monarchy	monarchia
monastery	kolostor
monday	hétfő
monetary	pénzügyi
money	pénz
monitored	figyelik
monitoring	megfigyelés
monk	szerzetes
monkey	majom
monkeys	majmok
monks	szerzetesek
monopoly	monopólium
monster	szörnyeteg
monsters	szörnyek
montenegro	Montenegró
month	hónap
monthly	havi
months	hónapok
monument	emlékmű
monuments	emlékművek
mood	hangulat
moon	hold
moral	erkölcsi
more	több
moreover	ráadásul
morning	reggel
morocco	Marokkó
mortality	halálozás
mortgage	jelzálog
Moscow	Moszkva
mosque	mecset
mosques	mecsetek
most	a legtöbb
mostly	többnyire
mother	anya
mothers	anyák
motion	mozgás
motivated	motivált
motivation	motiváció
motorcycle	motorbicikli
motors	motorok
mount	hegy
mountain	hegy
mountains	hegyek
mounted	felszerelt
mounting	beépítési
mouse	egér
mouth	száj
move	mozog
moved	megmozdult
movement	mozgalom
movements	mozgások
moves	mozog
movies	filmeket
moving	mozgó
Mr	úr
mrs	Asszony
ms	Kisasszony
much	sokkal
mud	sár
Muhammad	Mohamed
multi	több
multiple	többszörös
multiply	szaporodnak
munich	München
municipal	városi
municipalities	önkormányzatok
municipality	község
murder	gyilkosság
murdered	meggyilkolt
murders	gyilkosságok
muscle	izom
muscles	izmok
museum	múzeum
museums	múzeumok
mushroom	gomba
mushrooms	gombát
music	zene
musical	zenei
musician	zenész
musicians	zenészek
muslim	muszlim
muslims	muszlimok
must	kell
mutations	mutációk
mutual	kölcsönös
my	az én
myself	magamat
mysterious	rejtélyes
mystery	rejtély
myth	mítosz
mythology	mitológia
myths	mítoszok
nail	köröm
naive	naiv
naked	meztelen
name	név
named	nevezett
namely	ugyanis
names	neveket
napoleon	Napóleon
narrative	elbeszélés
narrow	keskeny
nasal	orr
nation	nemzet
national	nemzeti
nationalist	nacionalista
nationality	állampolgárság
nations	nemzetek
nationwide	országos
native	anyanyelvi
natural	természetes
naturally	természetesen
nature	természet
naval	haditengerészeti
navy	haditengerészet
Nazi	náci
near	közel
nearby	Közeli
nearest	legközelebbi
nearly	közel
necessarily	szükségszerűen
necessary	szükséges
neck	nyak
need	szükség
needed	szükséges
needle	tű
needs	igények
negative	negatív
negotiations	tárgyalásokat
neighbor	szomszéd
neighborhood	szomszédság
neighboring	szomszédos
neighbors	szomszédok
neither	se
nepal	Nepál
nephew	unokaöcs
nerve	ideg
nerves	idegek
nervous	ideges
nest	fészek
net	háló
netherlands	Hollandia
network	hálózat
networks	hálózatok
neural	idegi
neurons	neuronok
neutral	semleges
never	soha
nevertheless	Mindazonáltal
new	új
newly	újonnan
news	hírek
newspaper	újság
newspapers	újságok
next	következő
nice	szép
nicholas	Miklós
nickel	nikkel
nigeria	Nigéria
night	éjszaka
nights	éjszakák
nine	kilenc
nineteenth	tizenkilencedik
ninth	kilencedik
nitrogen	nitrogén
no	nem
noble	nemes
nobody	senki
node	csomópont
nodes	csomópontok
noise	zaj
noisy	zajos
nominated	jelölték
nomination	jelölés
non	nem
none	egyik sem
nonsense	ostobaság
noon	dél
nor	sem
normal	Normál
normally	normális esetben
norman	normann
norms	normák
north	északi
northeast	északkeleti
northern	északi
northwest	északnyugat
northwestern	északnyugati
norway	Norvégia
norwegian	norvég
nose	orr
not	nem
notable	jelentős
notably	nevezetesen
note	jegyzet
notebook	jegyzetfüzet
noted	neves
notes	jegyzetek
nothing	semmi
noticeable	észrevehető
noticed	megjegyezte
notion	fogalom
novel	regény
novels	regények
now	Most
nowadays	Manapság
nuclear	nukleáris
nucleus	atommag
number	szám
numbered	számozott
numbers	számok
numerous	számos
nurse	ápoló
nursing	gondozás
nutrients	tápanyagok
nutrition	táplálás
nutritional	táplálkozási
nuts	diófélék
oak	tölgy
obesity	elhízottság
obey	engedelmeskedik
object	tárgy
objective	célkitűzés
objectives	célokat
objects	tárgyakat
obligation	kötelezettség
obligations	kötelezettségeket
observation	megfigyelés
observations	megfigyelések
observe	megfigyelni
observed	megfigyelt
obstacles	akadályokat
obtain	szerezni
obtained	kapott
obvious	nyilvánvaló
obviously	magától értetődően
occasion	alkalom
occasional	alkalmi
occasionally	néha
occasions	alkalmak
occupation	Foglalkozása
occupied	megszállt
occupy	elfoglalni
occur	előfordul
occurred	történt
occurrence	esemény
occurring	előforduló
occurs	bekövetkezik
ocean	óceán
oceans	óceánok
october	október
odd	páratlan
of	nak,-nek
off	ki
offended	megsértődött
offensive	támadó
offer	ajánlat
offered	felajánlott
offering	ajánlat
offers	ajánlatokat
office	hivatal
officer	tiszt
officers	tisztek
offices	irodák
official	hivatalos
officially	hivatalosan
officials	tisztviselők
offset	beszámítás
offspring	utódok
often	gyakran
oh	ó
oil	olaj
oils	olajok
ok	rendben
okay	oké
old	régi
older	idősebb
oldest	legrégebbi
olive	olajbogyó
oliver	olivér
Olympic	olimpiai
olympics	olimpia
on	tovább
once	egyszer
one	egy
ones	azok
ongoing	folyamatban lévő
onion	hagyma
only	csak
onset	fellépő
onto	-ra
open	nyisd ki
opened	nyitott
opening	Nyítás
openly	nyíltan
opens	megnyílik
opera	opera
operate	működtet
operated	operált
operates	működik
operating	üzemeltetési
operation	művelet
operational	működőképes
operations	tevékenységek
operator	operátor
operators	operátorok
opinion	vélemény
opinions	vélemények
opponent	ellenfél
opponents	ellenfelek
opportunities	lehetőségeket
opportunity	lehetőség
oppose	ellenkezik
opposed	ellentétes
opposing	szemben álló
opposite	szemben
opposition	ellenzék
optical	optikai
optimal	optimális
optimization	optimalizálás
option	választási lehetőség
optional	választható
options	lehetőségek
or	vagy
oral	orális
orange	narancssárga
orbit	pálya
orchestra	zenekar
order	rendelés
ordered	elrendelte
orders	parancsokat
ordinary	rendes
ore	érc
organ	szerv
organic	organikus
organisation	szervezet
organisations	szervezetek
organised	szervezett
organism	szervezet
organisms	szervezetek
organization	szervezet
organizational	szervezeti
organizations	szervezetek
organize	szervez
organized	szervezett
organizing	szervezése
organs	szervek
orientation	irányultság
oriented	orientált
origin	eredet
original	eredeti
originally	eredetileg
originated	keletkezett
origins	eredet
orthodox	ortodox
other	Egyéb
others	mások
otherwise	másképp
Ottoman	török
our	a miénk
ourselves	minket
out	ki
outbreak	kitörés
outcome	eredmény
outcomes	eredmények
outdoor	szabadtéri
outer	külső
outfit	felszerelés
outlet	kimenet
outlets	kivezetések
output	Kimenet
outside	kívül
outstanding	kiemelkedő
oval	ovális
oven	sütő
over	felett
overall	átfogó
overcome	legyőzni
overnight	éjszakai
overseas	tengerentúli
overview	áttekintés
owe	tartozik
own	saját
owned	tulajdonában van
owner	tulajdonos
owners	tulajdonosok
ownership	tulajdonjog
owns	birtokolja
oxidation	oxidáció
oxide	oxid
oxygen	oxigén
pace	ütemben
pacific	békés
pack	csomag
package	csomag
packages	csomagokat
packaging	csomagolás
packed	csomagolt
pad	párna
pads	párnák
page	oldalon
pages	oldalakat
paid	fizetett
pain	fájdalom
painful	fájdalmas
paint	festék
painted	festett
painter	festő
painting	festmény
paintings	festmények
pair	pár
pairs	párok
Pakistan	Pakisztán
Pakistani	pakisztáni
palace	palota
pale	sápadt
palm	tenyér
pandemic	világjárvány
panels	panelek
panic	pánik
pants	nadrág
paper	papír
papers	papírokat
parade	felvonulás
paradise	paradicsom
paragraph	bekezdés
parallel	párhuzamos
parameter	paraméter
parameters	paramétereket
parasites	paraziták
parent	szülő
parents	szülők
Paris	Párizs
parish	plébánia
parked	leparkolt
parking	parkolás
parks	parkok
parliament	parlament
parliamentary	parlamenti
part	rész
partial	részleges
partially	részben
participants	résztvevők
participate	részt venni
participated	részt vett
participating	részt
participation	részvétel
particle	részecske
particles	részecskék
particular	különös
particularly	különösen
parties	a felek
partly	részben
partners	partnerek
partnership	partnerség
parts	alkatrészek
party	buli
passage	átjáró, átkelés
passed	átment
passenger	utas
passengers	utasok
passes	passzol
passing	elhaladó
passion	szenvedély
passionate	szenvedélyes
passive	passzív
passport	útlevél
password	Jelszó
past	múlt
pasta	tészta
paste	paszta
patch	tapasz
patches	foltok
patent	szabadalom
patented	szabadalmaztatott
path	pálya
pathology	patológia
paths	utak
pathway	útvonalat
patience	türelem
patient	beteg
patients	betegek
patrol	járőr
patron	mecénás
pattern	minta
patterns	minták
paul	Pál
pay	fizetés
paying	fizető
payment	fizetés
payments	kifizetések
pays	fizet
peace	béke
peaceful	Békés
peak	csúcs
peaks	csúcsok
pearl	gyöngyszem
peasants	parasztok
peel	héj
peer	egyenrangú
pen	toll
penalty	büntetés
pencil	ceruza
peninsula	félsziget
pension	nyugdíj
people	emberek
peoples	népek
pepper	bors
perceived	érzékelt
percent	százalék
percentage	százalék
perception	észlelés
perfect	tökéletes
perform	előadni
performance	teljesítmény
performances	előadások
performed	teljesített
performing	előadó
performs	végez
perhaps	talán
period	időszak
periodic	időszakos
periods	időszakokban
peripheral	kerületi
permanent	állandó
permanently	tartósan
permission	engedély
permit	engedély
permitted	megengedett
perry	körtebor
persecution	üldözés
persian	perzsa
persistent	kitartó
person	személy
personal	személyes
personality	személyiség
personally	személyesen
personnel	személyzet
persons	személyek
perspective	perspektíva
pet	házi kedvenc
peter	Péter
pets	háziállatok
petty	piti
pharmaceutical	gyógyszerészeti
pharmacy	gyógyszertár
phase	fázis
phases	fázisok
phenomena	jelenségek
phenomenon	jelenség
Philippine	Fülöp
philippines	Fülöp-szigetek
philosophers	filozófusok
philosophical	filozófiai
philosophy	filozófia
Phoenix	Főnix
phone	telefon
phones	telefonok
phosphate	foszfát
photo	fénykép
photographer	fotós
photographs	fényképeket
photography	fényképezés
photos	fényképeket
phrase	kifejezés
phrases	kifejezéseket
physical	fizikai
physically	fizikailag
physician	orvos
physics	fizika
physiological	fiziológiai
piano	zongora
pick	szed
picked	válogatott
picking	szedés
picture	kép
pictures	képeket
pie	pite
piece	darab
pieces	darabok
pig	malac
pile	halom
pillow	párna
pills	tabletták
pilot	pilóta
pilots	pilóták
pine	fenyő
pink	rózsaszín
pioneer	úttörő
pipe	cső
pipes	csövek
pirates	kalózok
pit	gödör
pitch	hangmagasság
pity	kár
place	hely
placed	helyezett
placement	elhelyezés
places	helyeken
placing	elhelyezése
plague	pestis
plain	egyszerű
plains	síkságon
plan	terv
plane	repülőgép
planes	repülőgépek
planet	bolygó
planetary	planetáris
planets	bolygók
planned	tervezett
planning	tervezés
plans	terveket
plant	növény
planted	beültetett
planting	ültetés
plants	növények
plasma	vérplazma
plastic	műanyag
plate	lemez
plateau	fennsík
plates	tányérok
platform	felület
platforms	platformok
platinum	platina
play	játék
played	játszott
player	játékos
players	játékosok
playing	játszik
plays	játszik
playstation	Play Station
plaza	köztér
pleasant	kellemes
please	kérem
pleased	elégedett
pleasure	öröm
plenty	bőven
plot	cselekmény
plug	dugó
plus	plusz
pneumonia	tüdőgyulladás
pocket	zseb
pockets	zsebek
poem	vers
poems	verseket
poet	költő
poetry	költészet
point	pont
pointed	hegyes
points	pontokat
poison	méreg
poisoning	mérgezés
poisonous	mérgező
poker	póker
poland	Lengyelország
polar	poláris
pole	pólus
poles	pólusok
police	rendőrség
policies	irányelveket
policy	irányelv
polish	fényesít
polished	csiszolt
polite	udvarias
political	politikai
politically	politikailag
politician	politikus
politicians	politikusok
politics	politika
poll	közvélemény kutatás
pollution	környezetszennyezés
polymer	polimer
polymers	polimerek
pond	tavacska
pool	medence
pools	medencék
poor	szegény
poorly	rosszul
pope	pápa
popular	népszerű
popularity	népszerűség
populated	benépesített
population	népesség
populations	populációk
pork	sertéshús
port	kikötő
portable	hordozható
portal	portál
portion	adag
portions	adagokat
portrait	portré
portrayed	ábrázolták
ports	portok
Portugal	Portugália
portuguese	portugál
pose	póz
position	pozíció
positions	pozíciókat
positive	pozitív
possess	birtokolni
possession	birtoklása
possibilities	lehetőségeket
possibility	lehetőség
possible	lehetséges
possibly	esetleg
post	hozzászólás
posted	közzétéve
posterior	hátulsó
postponed	elhalasztották
posts	hozzászólások
pot	edény
potassium	kálium
potato	burgonya
potatoes	krumpli
potential	lehetséges
potentially	potenciálisan
potter	fazekas
pounds	fontot
pour	önteni
poured	öntött
poverty	szegénység
powder	por
power	erő
powered	hajtású
powerful	erős
powers	hatáskörök
practical	gyakorlati
practically	gyakorlatilag
practice	gyakorlat
practiced	gyakorolt
practices	gyakorlatok
practicing	gyakorló
practitioners	gyakorlók
praise	dicséret
praised	dicsérte
pray	imádkozik
prayer	ima
prayers	imák
pre	elő
precious	értékes
precipitation	csapadék
precise	pontos
precisely	pontosan
precision	pontosság
predators	ragadozók
predecessor	előző
predict	megjósolni
predicted	megjósolta
predominantly	túlnyomórészt
prefer	jobban szeret
preference	preferencia
preferred	előnyben részesített
prefers	előnyben részesíti
pregnancy	terhesség
pregnant	terhes
prehistoric	őskori
preliminary	előzetes
premier	miniszterelnök
premiere	bemutató
premiered	premierje
premises	helyiségek
premium	prémium
preparation	készítmény
preparations	előkészületek
prepare	készít
prepared	előkészített
preparing	felkészülés
prescribed	előírt
prescription	recept
presence	jelenlét
present	jelenlegi
presentation	bemutatás
presented	bemutatott
presenting	bemutatása
presents	bemutatja
preservation	megőrzés
preserve	megőrizni
preserved	konzervált
presidency	elnökség
president	elnök
presidential	elnöki
press	nyomja meg
pressed	sajtolt
pressing	megnyomva
pressure	nyomás
prestigious	tekintélyes
pretend	úgy tesznek
pretended	tettetett
pretty	szép
prevent	megakadályozni
prevented	megakadályozta
preventing	megakadályozva
prevention	megelőzés
prevents	megakadályozza
previous	előző
previously	korábban
prey	áldozat
price	ár
prices	árak
pride	büszkeség
priest	pap
priests	papok
primarily	elsősorban
primary	elsődleges
prime	elsőszámú
primitive	primitív
prince	herceg
princess	hercegnő
principal	fő
principle	elv
principles	elveket
print	nyomtatás
printed	nyomtatott
printer	nyomtató
printing	nyomtatás
prints	nyomatok
prior	előzetes
priority	kiemelten fontos
prison	börtön
prisoner	Rab
prisoners	foglyok
privacy	magánélet
private	magán
privately	privátban
prize	díj
probability	valószínűség
probably	valószínűleg
probe	szonda
problem	probléma
problems	problémákat
procedure	eljárást
procedures	eljárások
proceed	folytassa
proceedings	eljárás
process	folyamat
processed	feldolgozott
processes	folyamatokat
processing	feldolgozás
processor	processzor
proclaimed	hirdette ki
produce	előállítani
produced	előállított
producer	termelő
producers	termelők
produces	termel
producing	termelő
product	termék
production	Termelés
productions	produkciók
productions	were produkciók voltak
productive	termelő
productivity	termelékenység
products	Termékek
profession	szakma
professional	szakmai
professionals	szakemberek
professor	Egyetemi tanár
profile	profil
profiles	profilok
profit	nyereség
profitable	jövedelmező
profits	nyereséget
profound	mély
programme	program
programmes	programokat
programming	programozás
programs	programokat
progress	előrehalad
progression	progresszió
progressive	haladó
prohibited	tiltott
project	projekt
projection	kivetítés
projects	projektek
prolonged	meghosszabbított
prominent	kiemelkedő
promise	ígéret
promised	igért
promises	ígéreteket
promising	biztató
promote	népszerűsít
promoted	előléptették
promotes	előmozdítja
promoting	előmozdítása
promotion	promóció
prone	hajlamos
pronounced	kiejtett
proof	bizonyíték
proper	megfelelő
properly	megfelelően
properties	tulajdonságait
property	ingatlan
proportion	arány
proposal	javaslat
proposals	javaslatokat
propose	javasol
proposed	javasolta
prostate	prosztata
protagonist	főszereplő
protect	védeni
protected	védett
protecting	védelmező
protection	védelem
protective	védő
protects	védi
protein	fehérje
proteins	fehérjék
protest	tiltakozás
protestant	protestáns
protesters	tüntetők
protests	tiltakozik
protocol	jegyzőkönyv
protocols	protokollok
prototype	prototípus
proud	büszke
prove	bizonyít
proved	bizonyított
proven	igazolt
provide	biztosítani
provided	biztosítani
provider	szolgáltató
providers	szolgáltatók
provides	biztosítja
providing	gondoskodás
province	tartomány
provinces	tartományok
provincial	vidéki
provision	rendelkezés
provisions	rendelkezések
proximity	közelség
pseudo	ál
psychological	pszichológiai
psychology	pszichológia
public	nyilvános
publication	kiadvány
publications	kiadványok
publicly	nyilvánosan
publish	közzé
published	közzétett
publisher	kiadó
publishing	kiadás
pull	Húzni
pulled	húzta
pulling	húzás
pulmonary	tüdő-
pulp	pép
pump	szivattyú
pumping	szivattyúzás
pumps	szivattyúk
punish	megbüntetni
punished	megbüntették
punishment	büntetés
pupils	tanulók
purchase	Vásárlás
purchased	vásárolt
purchasing	vásárlás
pure	tiszta
purely	tisztán
purity	tisztaság
purple	lila
purpose	célja
purposes	célokra
pursue	üldözni
pursued	üldözött
push	nyom
pushed	meglökött
pushing	toló
put	tegye
Putin	putyin
puts	tesz
putting	elhelyezés
puzzle	kirakós játék
pyramid	piramis
qualification	képesítés
qualified	képzett
qualifying	minősítő
qualities	minőségeket
quality	minőség
quantitative	mennyiségi
quantities	mennyiségeket
quantity	Mennyiség
quantum	kvantum
quarter	negyed
quarters	szállás
quartz	kvarc
queen	királynő
queens	királynők
quest	küldetés
question	kérdés
questioned	megkérdőjelezték
questions	kérdéseket
quick	gyors
quickly	gyorsan
quiet	csendes
quietly	csendesen
quit	Kilépés
quite	egészen
rabbit	nyúl
rabbits	nyulak
race	verseny
races	versenyek
racial	faji
racing	verseny
racism	rasszizmus
racist	rasszista
radiation	sugárzás
radical	radikális
radio	rádió
radioactive	radioaktív
raid	rajtaütés
rail	vasút
railroad	vasút
railway	vasúti
railways	vasutak
rain	eső
rainbow	szivárvány
raining	esik az eső
rains	esők
rainy	esős
raise	emel
raised	emelt
raising	emelés
rally	gyűlés
ran	futott
random	véletlen
range	hatótávolság
ranges	tartományok
ranging	körű
rank	rang
ranked	rangsorolt
ranking	rangsor
ranks	rangok
rape	erőszak
rapid	gyors
rapidly	gyorsan
rare	ritka
rarely	ritkán
rat	patkány
rate	mérték
rated	névleges
rates	árfolyamok
rather	Inkább
rating	értékelés
ratings	értékelések
ratio	hányados
rational	racionális
rats	patkányok
raw	nyers
ray	sugár
rays	sugarak
re	újra
reach	elérheti
reached	elérte
reaches	elér
reaching	elérve
reaction	reakció
reactions	reakciók
reactive	reaktív
reactor	reaktor
read	olvas
reader	olvasó
readers	olvasók
reading	olvasás
reads	olvas
real	igazi
realistic	reális
reality	valóság
realize	Rájön
realized	rájött
really	igazán
realm	birodalom
rear	hátulsó
reason	ok
reasonable	ésszerű
reasoning	érvelés
reasons	okokból
rebel	lázadó
rebellion	lázadó
rebels	lázadók
rebuilt	átépítették
receive	kap
received	kapott
receiver	vevő
receives	kap
receiving	fogadása
recent	friss
recently	mostanában
reception	recepció
receptors	receptorok
recipe	recept
recipes	receptek
recipient	befogadó
recognised	elismert
recognition	elismerés
recognize	elismerik
recognized	elismert
recommend	ajánlani
recommendation	ajánlást
recommendations	ajánlásokat
recommended	ajánlott
reconstruction	újjáépítés
record	rekord
recorded	rögzített
recording	felvétel
recordings	felvételeket
records	rekordokat
recover	visszaszerez
recovered	felépült
recovery	felépülés
recreation	pihenés
recreational	szabadidős
recruited	beszervezett
rectangular	négyszögletes
recurring	ismétlődő
recycling	újrafeldolgozás
red	piros
reduce	csökkenteni
reduced	csökkent
reduces	csökkenti
reducing	csökkenti
reduction	csökkentés
reed	nád
reef	zátony
refer	utal
reference	referencia
references	hivatkozások
referendum	népszavazás
referred	hivatkozott
referring	utalva
refers	utal
refined	kifinomult
reflect	tükrözik
reflected	tükröződött
reflection	visszaverődés
reflects	tükrözi
reformed	református
reforms	reformokat
refrigerator	hűtőszekrény
refuge	menedék
refugees	menekültek
refuse	megtagadja
refused	visszautasította
refuses	megtagadja
regard	tekintettel
regarded	tekintett
regarding	tekintetében
regardless	tekintet nélkül
regime	rezsim
regiment	ezred
region	vidék
regional	regionális
regions	régiók
register	Regisztráció
registered	bejegyzett
registration	bejegyzés
regret	megbánás
regular	szabályos
regularly	rendszeresen
regulate	szabályoz
regulated	szabályozott
regulation	szabályozás
regulations	előírások
regulatory	szabályozó
rehabilitation	rehabilitáció
reign	uralkodik
reinforced	megerősített
reject	elutasít
rejected	elutasítva
rejection	elutasítás
related	összefüggő
relates	kapcsolódik
relating	kapcsolatos
relation	kapcsolat
relations	kapcsolatokat
relationship	kapcsolat
relationships	kapcsolatok
relative	relatív
relatives	rokonai
relax	lazíts
relaxation	kikapcsolódás
relaxed	kipihent
relaxing	pihentető
relay	relé
release	kiadás
released	kiadták
releases	kiadja
releasing	felszabadító
relevant	ide vonatkozó
reliability	megbízhatóság
reliable	megbízható
relief	megkönnyebbülés
relieve	enyhíteni
religion	vallás
religions	vallások
religious	vallási
relocated	áthelyezték
rely	támaszkodni
remain	marad
remained	maradt
remaining	többi
remains	maradványok
remarkable	figyelemre méltó
remedy	jogorvoslat
remember	emlékezik
remembered	Emlékezett
remind	emlékeztet
reminds	emlékeztet
reminiscent	emlékeztető
remote	távoli
removal	eltávolítás
remove	távolítsa el
removed	eltávolították
removing	eltávolítása
renaissance	reneszánsz
renal	vese
renamed	átnevezték
renewable	megújuló
renewed	megújult
renovated	felújított
renovation	felújítása
renowned	híres
rent	bérlés
rental	bérbeadás
rented	bérelt
repair	javítás
repaired	javítva
repairs	javítások
repeat	ismétlés
repeated	megismételt
repeatedly	többször
replace	cserélje ki
replaced	lecserélték
replacement	csere
replacing	cseréje
report	jelentés
reported	jelentették
reportedly	állítólag
reporter	riporter
reports	jelentéseket
represent	képviselni
representation	reprezentáció
representative	reprezentatív
representatives	képviselői
represented	képviselve
representing	képviselő
represents	képviseli
reproduce	szaporodni
reproduction	reprodukció
reproductive	szaporodó
republic	köztársaság
republican	köztársasági
reputation	hírnév
request	kérés
requested	kérte
requests	kéréseket
require	igényelnek
required	kívánt
requirement	követelmény
requirements	követelményeknek
requires	igényel
requiring	igénylő
rescue	mentés
research	kutatás
researcher	kutató
researchers	kutatók
resemble	hasonlítani
resembles	hasonlít
reservation	foglalás
reserve	lefoglal
reserved	fenntartott
reserves	tartalékok
reservoir	rezervoár
residence	rezidencia
resident	lakos
residential	lakó
residents	lakosok
resignation	lemondás
resigned	lemondó
resin	gyanta
resist	ellenáll
resistance	ellenállás
resistant	ellenálló
resolution	felbontás
resolve	elhatározás
resolved	megoldva
resort	üdülő
resource	forrás
resources	erőforrások
respect	tisztelet
respected	tisztelt
respective	illető
respectively	illetőleg
respiratory	légúti
respond	reagál
responded	válaszolt
response	válasz
responses	válaszokat
responsibilities	felelősségeket
responsibility	felelősség
responsible	felelős
rest	pihenés
restaurant	étterem
restaurants	éttermek
restoration	felújítás
restore	visszaállítás
restored	helyreállították
restricted	korlátozott
restrictions	korlátozásokat
result	eredmény
resulted	eredményezett
resulting	eredő
results	eredmények
resumed	folytatta
retail	kiskereskedelem
retain	megtartani
retained	megtartva
retire	visszavonul
retired	nyugdíjas
retirement	nyugdíjazás
retreat	visszavonulás
return	Visszatérés
returned	visszatért
returning	visszatérő
returns	visszatér
reveal	felfed
revealed	kiderült
reveals	feltárja
revenge	bosszú
revenue	bevételt
reverse	fordított
review	felülvizsgálat
reviewed	áttekintette
reviews	vélemények
revised	átdolgozva
revival	ébredés
revived	újjáéledt
revolt	lázadás
revolution	forradalom
revolutionary	forradalmi
reward	jutalom
rhythm	ritmus
rice	rizs
rich	gazdag
rid	megszabadulni
ride	lovagol
ridge	gerinc
ridiculous	nevetséges
riding	lovaglás
rifle	puska
right	jobb
rights	jogokat
rigid	merev
ring	gyűrű
rings	gyűrűk
rise	emelkedik
rises	emelkedik
rising	emelkedő
risk	kockázat
risks	kockázatokat
ritual	szertartás
rituals	rituálék
rival	vetélytárs
rivals	riválisok
river	folyó
rivers	folyók
road	út
roads	utak
rob	rabolni
robbery	rablás
robin	vörösbegy
robots	robotok
robust	erős
rock	szikla
rocket	rakéta
rocks	sziklák
rocky	sziklás
rod	rúd
roger	helyes
role	szerep
roles	szerepeket
roll	tekercs
rolled	gurult
roller	henger
rolling	gördülő
rolls	tekercs
roman	római
romance	románc
romania	románia
Romanian	román
romans	rómaiak
romantic	romantikus
rome	Róma
roof	tető
room	szoba
rooms	szobák
root	gyökér
rooted	gyökeres
roots	gyökerei
rope	kötél
rose	rózsa
roses	rózsákat
rotary	forgó
rotating	forgó
rotation	forgás
rotten	rothadt
rough	durva
roughly	nagyjából
round	kerek
rounded	lekerekített
rounds	fordulóban
route	útvonal
routes	útvonalak
routine	rutin
row	sor
rows	sorokat
royal	királyi
rub	dörzsölés
rubber	radír
rude	durva
rugby	rögbi
ruin	ROM
ruins	romok
rule	szabály
ruled	uralkodott
ruler	vonalzó
rulers	uralkodók
rules	szabályokat
ruling	uralkodó
rumors	pletykák
run	fuss
runner	futó
running	futás
runs	fut
rural	vidéki
rush	rohanás
rushed	rohant
russia	Oroszország
russian	orosz
russians	oroszok
sacred	szent
sacrifice	áldozat
sad	szomorú
sadness	szomorúság
safe	biztonságos
safely	biztonságosan
safety	biztonság
said	mondott
sail	vitorla
sailed	hajózott
sailing	vitorlázás
sailors	tengerészek
saint	szent
saints	szentek
sake	kedvéért
salad	saláta
salary	fizetés
sale	eladás
sales	értékesítés
salmon	lazac
salt	só
salts	sók
salvation	megváltás
same	azonos
sami	szami
sample	minta
samples	minták
samuel	Sámuel
sanctions	szankciókat
sanctuary	szentély
sand	homok
sandwich	szendvics
sandy	homokos
sang	énekelt
santa	Télapó
sarah	Sára
sat	ült
satellite	műhold
satellites	műholdak
satisfaction	elégedettség
satisfied	elégedett
satisfy	kielégíteni
saturday	szombat
sauce	szósz
Saudi	Szaúdi
sausage	kolbász
save	megment
saved	mentett
saving	megtakarítás
savings	megtakarítás
saw	fűrész
say	mond
saying	mondás
says	mondja
scale	skála
scales	Mérleg
scan	letapogatás
scandal	botrány
scare	megijeszt
scared	megrémült
scary	ijedős
scattered	elszórt
scenario	forgatókönyv
scene	színhely
scenes	jelenetek
scent	illat
schedule	menetrend
scheduled	Ütemezett
scheme	rendszer
schemes	sémák
scholar	tudós
scholars	tudósok
scholarship	ösztöndíj
school	iskola
schools	iskolák
science	tudomány
sciences	tudományok
scientific	tudományos
scientist	tudós
scientists	tudósok
scope	hatálya
score	pontszám
scored	gólt szerzett
scores	pontszámokat
scoring	pontozás
scottish	skót
scratch	karcolás
scream	sikoly
screaming	sikoltozva
screen	képernyő
screening	szűrés
screenplay	forgatókönyv
screens	képernyők
screw	csavar
script	forgatókönyv
sculpture	szobor
sculptures	szobrok
sea	tenger
seal	fóka
sealed	zárt
seals	pecsétek
search	keresés
searched	keresett
searching	keresés
seas	tengerek
season	évad
seasonal	szezonális
seasons	évszakok
seat	ülés
seats	ülések
second	második
secondary	másodlagos
seconds	másodpercig
secret	titok
secretary	titkár
secretly	titkosan
secrets	titkok
section	szakasz
sections	szakaszok
sector	ágazat
sectors	ágazatokban
secular	világi
secure	biztonságos
secured	biztosított
security	Biztonság
see	lát
seed	mag
seeds	magvak
seeing	látás
seek	keresni
seeking	keres
seeks	keresi
seem	látszik
seemed	úgy tűnt
seemingly	látszólag
seems	úgy tűnik
seen	látott
sees	lát
segment	szegmens
segments	szegmensek
seized	lefoglalták
select	válassza ki
selected	kiválasztott
selection	kiválasztás
selective	szelektív
self	maga
selfish	önző
sell	elad
seller	eladó
selling	eladási
sells	eladja
semi	félig
senate	szenátus
senator	szenátor
send	Küld
sending	küldés
sends	küld
senior	idősebb
sensation	szenzáció
sense	érzék
senses	érzékszervek
sensitive	érzékeny
sensitivity	érzékenység
sensor	érzékelő
sensors	érzékelők
sensory	szenzoros
sent	küldött
sentence	mondat
sentenced	elítélték
sentences	mondatokat
separate	különálló
separated	elválasztott
separately	külön
separation	elválasztás
september	szeptember
sequel	folytatás
sequence	sorrend
sequences	sorozatok
serbia	Szerbia
Serbian	szerb
serial	sorozatszám
series	sorozat
serious	komoly
seriously	Komolyan
serum	szérum
servants	szolgák
serve	szolgál
served	szolgált
server	szerver
servers	szerverek
serves	szolgál
service	szolgáltatás
services	szolgáltatások
serving	szolgáló
session	ülés
sessions	üléseken
set	készlet
sets	készletek
setting	beállítás
settings	beállítások
settle	rendezni
settled	letelepedett
settlement	település
settlements	települések
settlers	telepesek
seven	hét
seventh	hetedik
several	számos
severe	szigorú
severely	szigorúan
severity	súlyossága
sex	szex
sexual	szexuális
shade	árnyék
shades	árnyalatok
shadow	árnyék
shadows	árnyékok
shaft	tengely
shah	sah
shake	ráz
shaking	rázás
shall	kell
shallow	sekély
shame	szégyen
shape	alak
shaped	alakú
shapes	formák
share	Ossza meg
shared	megosztott
shares	megoszt
sharing	megosztás
shark	cápa
sharks	cápák
sharp	éles
she	ő
shed	fészer
sheep	juh
sheet	lap
sheets	ágynemű
shelf	polc
shell	héj
shells	kagylók
shelter	menedék
shepherd	pásztor
sheriff	seriff
shield	pajzs
shift	váltás
shifted	eltolódott
shine	ragyog
ship	hajó
shipping	szállítás
ships	hajókat
shirt	ing
shirts	ingek
shit	szar
shock	sokk
shocked	döbbent
shoe	cipő
shoes	cipő
shook	megrázta
shoot	lő
shooting	lövés
shoots	lő
shop	üzlet
shopping	bevásárlás
shops	üzletek
shore	partra
shore	partra
short	rövid
shorter	rövidebb
shortly	hamarosan
shorts	rövidnadrág
shot	lövés
shots	lövések
should	kellene
shoulder	váll
shoulders	vállak
show	előadás
showed	mutatta
shower	zuhany
showing	mutatja
shown	Látható
shows	mutatja
shrimp	garnélarák
shut	bezárva
shuttle	űrsikló
shy	félénk
siblings	testvérek
sick	beteg
side	oldal
sided	oldalú
sides	oldalain
siege	ostrom
sierra	hegylánc
sight	látás
sign	jel
signal	jel
signals	jeleket
signature	aláírás
signed	aláírva
significance	jelentőség
significant	jelentős
significantly	szignifikánsan
signing	aláírás
signs	jelek
silence	csend
silent	csendes
silicon	szilícium
silk	selyem
silver	ezüst
similar	hasonló
similarities	hasonlóságok
similarly	hasonlóképpen
simple	egyszerű
simplest	legegyszerűbb
simplicity	egyszerűség
simply	egyszerűen
simulation	szimuláció
simultaneous	egyidejű
simultaneously	egyidejűleg
sin	bűn
since	mivel
sincere	őszinte
sing	énekel
singapore	szingapúr
singer	énekes
singers	énekesek
singing	éneklés
single	egyetlen
singles	egyedülállók
sings	énekel
sink	mosogató
sins	bűnök
sir	uram
sister	nővér
sisters	nővérek
site	webhely
sites	oldalak
sits	ül
sitting	ülés
situated	található
situation	helyzet
situations	helyzetekben
six	hat
sixteen	tizenhat
sixth	hatodik
sixty	hatvan
size	méret
sized	méretű
sizes	méretek
skeleton	csontváz
sketch	vázlat
ski	sí
skiing	síelés
skill	készség
skilled	szakképzett
skin	bőr
skip	kihagyni
skirt	szoknya
skull	koponya
sky	ég
skyscrapers	felhőkarcoló
slaughterhouses	vágóhidak
slave	rabszolga
slavery	rabszolgaság
slaves	rabszolgák
sleep	alvás
sleeping	alvás
sleepy	álmos
sleeve	ujj
sleeves	ujjú
slept	aludt
slide	csúszik
sliding	csúszó
slight	enyhe
slightly	némileg
slip	csúszás
slipped	megcsúszott
slope	lejtő
slopes	lejtőkön
slot	rés
slow	lassú
slowly	lassan
small	kicsi
smaller	kisebb
smallest	legkisebb
smart	Okos
smarter	okosabb
smartphone	okostelefon
smell	szag
smells	szagokat
smile	mosoly
smiled	mosolygott
smiling	mosolygás
smith	Kovács
smoke	füst
smoked	füstölt
smoking	dohányzó
smooth	sima
snack	falatozás
snake	kígyó
snakes	kígyók
snow	hó
so	így
soap	szappan
soccer	futball
social	szociális
socialist	szocialista
societies	társaságok
society	társadalom
socio	szocio
socks	zokni
sodium	nátrium
sofa	kanapé
soft	puha
software	szoftver
soil	talaj
soils	talajok
solar	nap
sold	eladott
soldier	katona
soldiers	katonák
sole	egyetlen
solely	kizárólag
solid	szilárd
solidarity	szolidaritás
solo	szóló
soluble	oldódó
solution	megoldás
solutions	megoldásokat
solve	megoldani
solved	megoldva
solvent	oldószer
solving	megoldása
somalia	Szomália
some	néhány
somehow	valahogy
someone	valaki
something	valami
sometime	majd valamikor
sometimes	néha
somewhat	némileg
somewhere	valahol
son	fiú
song	dal
songs	dalok
songwriter	dal író
sons	fiai
soon	hamar
sooner	hamarabb
sophisticated	kifinomult
sorry	sajnálom
sort	fajta
sought	keresett
soul	lélek
souls	lelkek
sound	hang
sounds	hangokat
soundtrack	hangsáv
soup	leves
sour	savanyú
source	forrás
sources	források
south	déli
southeast	délkeleti
southeastern	délkeleti
southern	déli
southwest	délnyugati
sovereign	szuverén
soviet	szovjet
spa	gyógyfürdő
space	hely
spacecraft	űrhajó
spaces	terek
spacious	tágas
Spain	Spanyolország
spanish	spanyol
spare	tartalék
spark	szikra
spatial	térbeli
speak	beszél
speaker	hangszóró
speakers	hangszórók
speaking	beszélő
speaks	beszél
special	különleges
specialist	szakember
specialists	szakemberek
specialized	specializált
specially	különösen
specialty	különlegesség
species	faj
specific	különleges
specifically	kimondottan
specification	leírás
specified	meghatározott
specify	adja meg
specimen	mintadarab
specimens	példányok
spectacular	látványos
spectrum	spektrum
speech	beszéd
speed	sebesség
speeds	sebességek
spell	varázslat
spend	tölt
spending	kiadások
spends	költ
spent	költött
sphere	szféra
spherical	gömbölyű
spicy	fűszeres
spider	pók
spiders	pókok
spinal	gerinc-
spine	gerinc
spinning	fonás
spiral	spirál
spirit	szellem
spirits	szellemek
spiritual	lelki
spit	nyárs
split	hasított
spoke	beszéltem
spoken	beszélt
sponsor	szponzor
sponsored	szponzorált
spontaneous	spontán
spoon	kanál
sporting	sport
sports	sport
spot	folt
spots	helyek
spotted	észlelve
spray	permet
spread	terjedés
spreading	terjed
spring	tavaszi
springs	rugók
spy	kém
squad	osztag
squadron	repülőszázad
square	négyzet
squares	négyzetek
stability	stabilitás
stable	stabil
stack	Kazal
stadium	stádium
stadiums	stadionok
staff	személyzet
stage	színpad
staged	megrendezett
stages	szakasz
stained	foltos
stainless	rozsdamentes
stairs	lépcsők
stake	tét
stamp	bélyeg
stamps	bélyegek
stand	állvány
standard	alapértelmezett
standards	szabványoknak
standing	álló
stands	áll
star	csillag
starred	csillagos
starring	főszerepben
start	Rajt
started	elindult
starting	induló
starts	elindul
state	állapot
stated	megállapított
statement	nyilatkozat
statements	nyilatkozatok
states	Államok
static	statikus
station	állomás
stations	állomások
statistical	statisztikai
statistics	statisztika
statue	szobor
status	állapot
stay	marad
stayed	maradt
staying	tartózkodás
stays	marad
steady	állandó
steal	lop
stealing	lopás
steam	gőz
steel	acél
steep	meredek
steering	kormányzás
stem	származik
stems	szára
step	lépés
Stephen	István
stepped	lépett
steps	lépések
stereo	sztereó
steven	István
stick	rúd
sticks	botok
still	még mindig
stimulate	serkenteni
stimulation	stimuláció
stir	keverjük meg
stock	Készlet
stocks	készletek
stole	stóla
stolen	lopott
stomach	gyomor
stone	kő
stones	kövek
stood	állt
stop	állj meg
stopped	megállt
stopping	megállás
stops	megáll
storage	tárolás
store	bolt
stored	tárolva
stores	üzletek
stories	történeteket
storm	vihar
storms	viharok
story	sztori
stove	tűzhely
straight	egyenes
strain	törzs
strains	törzsek
strange	furcsa
stranger	idegen
strangers	idegenek
strategic	stratégiai
strategies	stratégiákat
strategy	stratégia
straw	szalma
stream	folyam
streaming	folyó
streams	patakok
street	utca
streets	utcák
strength	erő
strengthen	erősíteni
strengthened	megerősített
strengthening	erősítése
stress	feszültség
stressed	hangsúlyozta
stretch	nyújtózkodni
stretched	feszített
stretching	nyújtás
strict	szigorú
strictly	szigorúan
strike	sztrájk
strikes	sztrájkol
striking	meglepő
string	húr
strings	húrok
strip	szalag
strips	csíkok
strong	erős
stronger	erősebb
strongest	legerősebb
strongly	erősen
struck	ütött
structural	szerkezeti
structure	szerkezet
structured	strukturált
structures	szerkezetek
struggle	küzdelem
struggled	küzdött
struggling	küszködik
stub	csonk
stubborn	makacs
stuck	megragadt
student	diák
students	hallgatók
studied	tanult
studies	tanulmányok
studio	stúdió
study	tanulmány
studying	tanul
stuff	dolog
stuffed	töltött
stunning	lenyűgöző
stupid	hülye
style	stílus
styles	stílusok
stylish	elegáns
sub	alatti
subject	tantárgy
subjected	alávetve
subjects	tantárgyak
submarine	tengeralattjáró
submit	Beküldés
submitted	benyújtott
subsequent	későbbi
subsequently	később
subsidiary	leányvállalat
substance	anyag
substances	anyagokat
substantial	lényeges
substantially	lényegesen
substitute	helyettes
substrate	szubsztrát
subtle	kifinomult
suburb	külváros
suburban	külvárosi
suburbs	külvárosok
subway	metró
succeed	sikerül
succeeded	sikerült
success	siker
successful	sikeres
successfully	sikeresen
succession	utódlás
successor	utód
such	ilyen
sudden	hirtelen
suddenly	hirtelen
suffer	szenvedni
suffered	szenvedett
suffering	szenvedő
suffers	szenved
sufficient	elegendő
sugar	cukor
suggest	javasolja
suggested	javasolta
suggestion	javaslat
suggestions	javaslatokat
suggests	javasolja
suicide	öngyilkosság
suit	öltöny
suitable	alkalmas
suitcase	bőrönd
suite	lakosztály
suited	alkalmas
suits	ruhák
sulfur	kén
sultan	szultán
sum	összeg
summary	összefoglaló
summer	nyár
summit	csúcstalálkozó
sun	nap
sunday	vasárnap
sundays	vasárnap
sung	énekelte
sunlight	napfény
sunny	napos
sunset	napnyugta
super	szuper
superior	kiváló
supermarket	szupermarket
supernatural	természetfölötti
supervision	felügyelet
supplement	kiegészítés
supplements	kiegészítők
supplied	szállított
supplier	támogató
suppliers	szállítók
supplies	kellékek
supply	kínálat
support	támogatás
supported	támogatott
supporter	támogató
supporters	támogatói
supporting	támogató
supports	támogatja
supposed	feltételezett
suppress	elnyom
supreme	legfőbb
sure	biztos
surely	biztosan
surface	felület
surfaces	felületek
surgeon	sebész
surgery	sebészet
surgical	sebészeti
surprise	meglepetés
surprised	meglepődött
surprising	meglepő
surrender	megadás
surround	körülveszi
surrounded	körülvett
surrounding	környező
surroundings	környéke
surveillance	felügyelet
survey	felmérés
survival	túlélés
survive	túlélni
survived	túlélte
surviving	túlélni
survivors	túlélők
suspect	gyanúsított
suspected	feltételezett
suspended	felfüggesztett
suspension	felfüggesztés
suspicious	gyanús
sustainability	fenntarthatóság
sustainable	fenntartható
sustained	fenntartva
swallow	Nyel
swallowed	lenyelt
swear	esküszik
sweat	izzad
sweater	pulóver
sweden	Svédország
sweet	édes
sweets	édesség
swelling	duzzanat
swept	söpört
swim	úszás
swimming	úszás
swing	hinta
swiss	svájci
switch	kapcsoló
switched	váltott
switching	átkapcsolás
switzerland	Svájc
sword	kard
symbol	szimbólum
symbolic	szimbolikus
symbols	szimbólumok
symptom	tünet
symptoms	tünetek
synagogues	zsinagógák
syndrome	szindróma
synthesis	szintézis
synthetic	szintetikus
syria	Szíria
Syrian	szír
system	rendszer
systematic	szisztematikus
systemic	szisztémás
systems	rendszerek
table	asztal
tables	táblázatok
tablet	tabletta
tablets	tabletek
tactical	taktikai
tactics	taktikát
tag	címke
tags	címkéket
tail	farok
Taiwan	Tajvan
take	vesz
taken	vett
takes	veszi
taking	szedése
tale	mese
talent	tehetség
talented	tehetséges
tales	meséket
talk	beszélgetés
talked	beszélt
talking	beszél
talks	beszél
tall	magas
taller	magasabb
tank	tartály
tanks	tankok
tap	Koppintson a
tape	szalag
target	cél
targeted	célzott
targets	célpontok
task	feladat
tasks	feladatokat
taste	íz
tastes	ízek
tasty	ízletes
tattoo	tetoválás
taught	tanított
tax	adó
taxes	adókat
teach	tanít
teacher	tanár
teachers	tanárok
teaches	tanít
teaching	tanítás
teachings	tanításait
team	csapat
teams	csapatok
tear	könny
technical	műszaki
technically	technikailag
technique	technika
techniques	technikák
technological	technikai
technologies	technológiákat
technology	technológia
ted	megforgat
teenage	tizenéves
teenager	tizenéves
teenagers	tinédzserek
teeth	fogak
telephone	telefon
telescope	távcső
television	televízió
tell	Mondd
telling	sokatmondó
tells	elmondja
temperature	hőfok
temperatures	hőmérsékletek
temple	templom
temples	templomok
temporal	időbeli
temporarily	ideiglenesen
temporary	ideiglenes
ten	tíz
tend	hajlamos
tendency	tendencia
tender	pályázati kiírás
tends	hajlamos
tennis	tenisz
tens	tízesek
tense	feszült
tension	feszültség
tensions	feszültségek
tent	sátor
tenth	tizedik
tenure	birtoklás
term	kifejezést
terminal	terminál
terms	feltételeket
terrace	terasz
terrain	terep
terrestrial	földi
terrible	szörnyű
territorial	területi
territories	területeken
territory	terület
terrorism	terrorizmus
terrorist	terrorista
terry	frottír
test	teszt
testament	végrendelet
tested	tesztelve
testimony	bizonyság
testing	tesztelés
testosterone	tesztoszteron
tests	tesztek
text	szöveg
textile	textil
texts	szövegek
texture	struktúra
Thailand	Thaiföld
than	mint
thank	köszönet
thanks	Kösz
that	hogy
the	a
theater	színház
theaters	színházak
theatre	színház
theatrical	színházi
theft	lopás
their	az övék
them	őket
theme	téma
themed	témájú
themes	témákat
themselves	maguk
then	akkor
theological	teológiai
theology	teológia
theorem	tétel
theoretical	elméleti
theories	elméletek
theory	elmélet
therapeutic	gyógyászati
therapy	terápia
there	ott
thereby	ezáltal
therefore	ezért
thermal	termikus
these	ezek
thesis	tézis
they	ők
thick	vastag
thickness	vastagság
thief	tolvaj
thin	vékony
thing	dolog
things	dolgokat
think	gondol
thinking	gondolkodás
thinks	azt hiszi
third	harmadik
thirteen	tizenhárom
thirty	harminc
this	ez
thomas	Tamás
thoroughly	alaposan
those	azok
though	bár
thought	gondolat
thoughts	gondolatok
thousand	ezer
thousands	ezrek
thread	cérna
threads	szálak
threat	fenyegetés
threatened	megfenyegette
threatening	fenyegető
threats	fenyegetések
three	három
threshold	küszöb
threw	dobta
thriller	krimi
throat	torok
throne	trón
through	keresztül
throughout	végig
throw	dobás
throwing	dobás
thrown	dobott
thunder	mennydörgés
thursday	csütörtök
thus	és így
thyroid	pajzsmirigy
ticket	jegy
tickets	jegyek
tie	nyakkendő
tied	bekötött
tier	szint
ties	nyakkendők
tiger	tigris
tigers	tigrisek
tight	szoros
tightly	szorosan
tiles	csempe
timber	fűrészáru
time	idő
times	alkalommal
timing	időzítés
tin	ón-
tiny	apró
tip	tipp
tips	tippeket
tire	gumi
tired	fáradt
tires	gumiabroncsok
tissue	szövet
tissues	szövetek
titanium	titán
title	cím
titled	címmel
titles	címeket
to	nak nek
tobacco	dohány
today	Ma
together	együtt
toilet	WC
tokyo	tokió
told	mondta
tolerance	megértés
tolerate	elviselni
toll	útdíj
tomato	paradicsom
tomatoes	paradicsom
tomb	síremlék
tomorrow	holnap
tone	hangot
tones	hangok
tongue	nyelv
tonight	ma este
tons	tonna
too	is
took	vett
tool	eszköz
tools	eszközöket
tooth	fog
top	tetejére
topic	téma
topics	témákat
torn	szakadt
torture	kínzás
tortured	megkínozták
total	teljes
totally	teljesen
touch	érintés
touched	érintett
touching	megható
tough	kemény
tour	túra
toured	turnézott
touring	túrázás
tourism	idegenforgalom
tourist	turista
tourists	turisták
tournament	versenyen
tournaments	versenyeken
tours	túrák
toward	felé
towards	felé
tower	torony
towers	tornyok
town	város
township	község
toxic	mérgező
toxicity	toxicitás
toxins	toxinok
toy	játék
toys	játékok
trace	nyom
traced	nyomon követni
traces	nyomait
track	nyomon követni
tracking	követés
tracks	pályák
tract	traktus
trade	kereskedelmi
traded	kereskedtek
traders	kereskedők
trading	kereskedés
tradition	hagyomány
traditional	hagyományos
traditionally	hagyományosan
traditions	hagyományok
traffic	forgalom
tragedy	tragédia
tragic	tragikus
trail	nyom
trailer	filmelőzetes
trails	nyomvonalak
train	vonat
trained	kiképzett
training	kiképzés
trains	vonatok
traits	vonások
trans	ford
transaction	tranzakció
transactions	tranzakciók
transfer	átruházás
transferred	át
transfers	transzferek
transform	átalakítani
transformation	átalakítás
transformed	átalakult
transit	tranzit
transition	átmenet
translate	fordít
translated	lefordított
translation	fordítás
translations	fordítások
transmission	terjedés
transmitted	továbbított
transparency	átláthatóság
transparent	átlátszó
transport	szállítás
transportation	szállítás
transported	szállítják
trap	csapda
trapped	csapdába esett
trash	szemét
trauma	sérülés
travel	utazás
traveled	utazott
travelers	utazók
traveling	utazó
travelled	utazott
travels	utazik
treasure	kincs
treat	csemege
treated	kezelt
treating	kezelésében
treatment	kezelés
treatments	kezelések
treaty	szerződés
tree	fa
trees	fák
trend	irányzat
trends	trendek
trial	próba
trials	próbatételek
triangle	háromszög
tribal	törzsi
tribe	törzs
tribes	törzsek
tribute	tisztelgés
trick	trükk
tricks	trükköket
tried	megpróbálta
tries	próbálkozik
trigger	ravaszt
triggered	kiváltotta
trinity	Szentháromság
trio	trió
trip	utazás
triple	hármas
trips	kirándulások
troops	csapatok
trophy	trófea
tropical	tropikus
trouble	baj
truck	kamion
trucks	teherautók
true	igaz
truly	valóban
trump	adu
trunk	törzs
trust	bizalom
trusted	megbízott
truth	igazság
try	próbálja meg
trying	megpróbálja
tube	cső
tubes	csövek
tuesday	kedd
tumors	daganatok
tunnel	alagút
turbine	turbina
turkey	pulyka
turkish	török
turn	fordulat
turned	fordult
turner	esztergályos
turning	fordulás
turns	fordul
turtle	teknősbéka
turtles	teknősök
tv	tévé
twelve	tizenkét
twentieth	huszadik
twenty	húsz
twice	kétszer
twin	iker
twins	Ikrek
twist	csavar
twisted	csavart
two	két
type	típus
types	típusok
typical	tipikus
typically	jellemzően
ugly	csúnya
Ukraine	Ukrajna
Ukrainian	ukrán
ultimate	végső
ultimately	végül
ultrasound	ultrahang
umbrella	esernyő
un	ENSZ
uncertain	bizonytalan
uncertainty	bizonytalanság
uncle	nagybácsi
unclear	homályos
uncomfortable	kényelmetlen
unconscious	öntudatlan
under	alatt
undergo	alávetni
undergraduate	egyetemista
underground	föld alatt
underlying	mögöttes
understand	megért
understanding	megértés
understands	érti
understood	értett
undertaken	vállalt
underwater	viz alatti
underwent	átesett
undoubtedly	kétségtelenül
unemployment	munkanélküliség
unexpected	váratlan
unfair	tisztességtelen
unfortunate	szerencsétlen
unfortunately	sajnálatos módon
unhappy	boldogtalan
unified	egységes
uniform	egyenruha
uniforms	egyenruhák
union	unió
unions	szakszervezetek
unique	egyedi
unit	Mértékegység
united	egyesült
units	egységek
unity	egység
universal	egyetemes
universe	világegyetem
universities	egyetemek
university	egyetemi
unknown	ismeretlen
unless	hacsak
unlike	nem úgy mint
unlikely	valószínűtlen
unlimited	korlátlan
unnecessary	szükségtelen
unpleasant	kellemetlen
unprecedented	példátlan
unstable	instabil
unsuccessful	sikertelen
until	amíg
unusual	szokatlan
unwanted	nem kívánt
up	fel
upcoming	közelgő
update	frissítés
updated	frissítve
updates	frissítéseket
upgrade	frissíteni
upon	esetén
upper	felső
uprising	felkelés
upset	szomorú
upstairs	emeleten
uranium	uránium
urban	városi
urgent	sürgős
urine	vizelet
us	minket
usa	Egyesült Államok
usage	használat
use	használat
used	használt
useful	hasznos
Useless	Hiábavaló
user	felhasználó
users	felhasználókat
uses	használ
using	segítségével
USSR	Szovjetunió
usual	szokásos
usually	általában
utility	hasznosság
vacation	vakáció
vaccine	vakcina
vaccines	védőoltások
vacuum	vákuum
vain	hiú
valid	érvényes
valley	völgy
valleys	völgyek
valuable	értékes
value	érték
valued	értékes
values	értékeket
valve	szelep
valves	szelepek
vampire	vámpír
van	furgon
variable	változó
variables	változók
variant	változat
variants	változatai
variation	variáció
variations	variációk
varied	változatos
varies	váltakozik
varieties	fajták
variety	fajta
various	különféle
vary	változnak
varying	változó
vascular	ér
vast	hatalmas
vector	vektor
vegetables	zöldségek
vegetation	növényzet
vehicle	jármű
vehicles	járművek
vein	véna
veins	erek
velocity	sebesség
venice	velence
ventilation	szellőzés
venture	vállalkozás
venue	helyszín
venues	helyszínek
verb	ige
verbs	igék
versatile	sokoldalú
verse	vers
verses	verseket
version	változat
versions	verziók
versus	ellen
vertical	függőleges
very	nagyon
vessel	hajó
vessels	hajók
veteran	veterán
veterans	veteránok
via	keresztül
vibration	rezgés
vice	helyettes
vicinity	közelébe
victim	áldozat
victims	áldozatok
victor	győztes
victorian	viktoriánus
victory	győzelem
video	videó-
videos	videókat
Vienna	Bécs
vietnamese	vietnami
view	Kilátás
viewed	megtekintve
viewers	nézők
viewing	nézegetése
views	nézetek
village	falu
villages	falvak
vintage	szüret
vinyl	bakelit
violation	megsértése
violations	jogsértéseket
violence	erőszak
violent	erőszakos
violin	hegedű
viral	vírusos
virgin	szűz
virtual	virtuális
virtually	gyakorlatilag
virtue	erény
virus	vírus
viruses	vírusok
visa	Vízum
visible	látható
vision	látomás
visit	látogatás
visited	meglátogatta
visiting	látogató
visitor	látogató
visitors	látogatók
visits	látogatások
visual	vizuális
vital	létfontosságú
vitamins	vitaminok
Vladimir	Vlagyimir
vocal	vokális
vocals	énekhang
voice	hang
voiced	zöngés
voices	hangokat
volcanic	vulkanikus
volcano	vulkán
voltage	feszültség
volume	hangerő
volumes	kötetek
voluntary	önkéntes
volunteer	önkéntes
volunteers	önkéntesek
vote	szavazás
voted	szavazott
voters	választók
votes	szavazatokat
votes	during szavazatok alatt
voting	szavazás
vulnerable	sebezhető
wage	bér
wages	bérek
waist	derék
wait	várjon
waited	várt
waiting	várakozás
wake	ébred
walk	séta
walked	sétált
walker	járóka
walking	gyaloglás
walks	sétál
wall	fal
wallet	pénztárca
walls	falak
want	akar
wanted	akarta
wants	akar
war	háború
ward	osztályon
warehouse	raktár
warfare	hadviselés
warm	meleg
warming	melegítés
warn	figyelmeztet
warned	figyelmeztetett
warner	figyelmeztető
warning	Figyelem
warrior	harcos
warriors	harcosok
wars	háborúk
was	volt
wash	mosás
washed	mosott
washing	mosás
wasn	volt
waste	Pazarlás
wasted	elpazarolt
wasting	pazarlás
watch	néz
watched	figyelt
watches	órákat
watching	nézni
water	víz
waters	vizek
wave	hullám
waves	hullámok
wax	viasz
way	út
ways	módokon
we	mi
weak	gyenge
weakened	legyengült
weakness	gyengeség
wealth	jólét
wealthy	gazdag
weapon	fegyver
weapons	fegyverek
wear	viselet
wearing	fárasztó
wears	visel
weather	időjárás
website	weboldal
websites	weboldalak
wedding	esküvő
wednesday	szerda
week	hét
weekend	hétvége
weekly	heti
weeks	hétig
weigh	mérlegelni
weight	súly
weird	furcsa
welcome	Üdvözöljük
welding	hegesztés
welfare	jólét
well	jól
wells	kutak
welsh	walesi
went	ment
were	voltak
weren	voltak
west	nyugat
western	nyugati
wet	nedves
whale	bálna
what	mit
whatever	tök mindegy
wheat	búza
wheel	kerék
wheels	kerekek
when	mikor
whenever	bármikor
where	ahol
whereas	mivel
wherein	ahol
wherever	bárhol
whether	hogy vajon
which	melyik
while	míg
whilst	míg
whip	ostor
white	fehér
whoever	bárki
whole	egész
whom	kit
whose	akinek
why	miért
wide	széles
widely	széles körben
wider	szélesebb
widespread	széles körben elterjedt
widow	özvegy
width	szélesség
wife	feleség
wild	vad
wildlife	vadvilág
will	akarat
william	Vilmos
willing	hajlandó
win	győzelem
wind	szél
winding	kanyargó
window	ablak
windows	ablakok
winds	szelek
wine	bor
wines	borok
wing	szárny
wings	szárnyak
winner	győztes
winners	nyertesek
winning	nyerő
wins	nyer
winter	téli
wire	huzal
wireless	vezeték nélküli
wires	vezetékek
wisdom	bölcsesség
wise	bölcs
wish	szeretnék
wishes	kívánságait
witch	boszorkány
withdraw	visszavonulni
withdrawal	visszavonás
withdrawn	visszavont
withdrew	visszavonult
within	belül
without	nélkül
witness	tanú
witnessed	tanúja volt
witnesses	tanúk
wives	feleségek
woke	felébredt
wolf	farkas
wolves	farkasok
woman	nő
women	nők
won	nyerte
wonder	csoda
wonderful	csodálatos
wood	faipari
wooden	fa
woods	fák
wool	gyapjú
words	szavak
wore	viselt
work	munka
worked	dolgozott
worker	munkás
workers	dolgozók
working	dolgozó
workplace	munkahely
works	művek
workshop	Műhely
workshops	műhelyek
world	világ
worlds	világok
worldwide	világszerte
worms	férgek
worn	kopott
worried	aggódó
worries	aggodalmak
worry	aggodalom
worse	rosszabb
worship	imádat
worst	legrosszabb
worth	érdemes
worthy	méltó
would	lenne
wouldn	nem tenné
wound	seb
wounded	sebesült
wounds	sebek
woven	szőtt
wrap	betakar
wrapped	csomagolt
wrestling	birkózás
wrist	csukló
write	ír
writer	író
writers	írók
writes	írja
writing	írás
writings	írások
written	írott
wrong	rossz
wrote	írt
yacht	jacht
yard	udvar
yards	yard
year	év
years	évek
yeast	élesztő
yellow	sárga
yen	jen
yes	Igen
yesterday	tegnap
yet	még
yield	hozam
yoga	jóga
you	Ön
young	fiatal
younger	fiatalabb
youngest	legfiatalabb
yourself	saját magad
youth	ifjúság
zealand	Zéland
zero	nulla
zinc	cink
zone	zóna
zones	zónák
zoo	állatkert
