1	하나
10	십
10	열
100	백
1000	천
10 days	열흘
1st birthday	돌잔치
2	둘
20	스물
20	이십
3	삼
3	셋
30	삼십
30	서른
3 days	사흘
4	넷
4	사
40	마흔
40	사십
5	오
5	다섯
50	쉰
50	오십
6	육
6	여섯
60	예순
60	육십
7	칠
7	일곱
70	일흔
70	칠십
8	팔
8	여덟
80	여든
80	팔십
9	구
9	아홉
90	구십
90	아흔
abandon, throw away	버리다
ability	능력
ability	실력
about, around ~	쯤
about, medicine	약
absence	결석
absolutely	무조건
abstinence, temperance	금주
abusive language	욕
academic field	학문
(academic) paper	논문
academy, school	학원
accent	억양
access, enter	출입
accessory	액세서리
accident	사고
accommodation	숙소
accommodation fee	숙박비
accurately	정확히
acne	여드름
across	건너
across, the other side, opposite	맞은편
action, behavior	행동
activities	활동
actor	배우
acupuncture medicine	한약
a custom/event to make Kimchi in winter	김장
adaptation	적응
adding	추가
address	주소
adjective	형용사
adjustment	조절
admiration	감탄
admission	입학
admission	입장
admission fee	입장료
admission ticket	입장권
adult	어른
adult	성인
adult diseases, lifestyle diseases	성인병
advantage	장점
advantages and disadvantages	장단점
adventurous mind	모험심
advert	부사
advertisement	광고
advice	충고
a few, a number of	몇
a few days ago	엊그제
a few days, what date	며칠
affection	정
Africa	아프리카
after	후
after all	결국
after all, any way	어차피
after a long time	오랜만
after a long time	오래간만
after a long time	오랜만에
after a meal	식후
afternoon	오후
after-party	뒤풀이
after-sales service	애프터서비스
afterward	이후
again	다시
age	년대
age (honorific form)	연세
agency	중개소
age, old	나이
agony, distress	괴로움
agreement	찬성
agriculture	농사
aids	에이즈
air	공기
air conditioner	에어컨
aircraft	항공기
airfare	항공료
airfield, airport	비행장
airlines	항공사
airplane	비행기
airport	공항
a job offer	구인
album	앨범
alcohol	알코올
alcohol, liquor	술
a little	좀
a little	조금
a little more	좀더
all, before	전
all day	종일
all, entire	온통
all, entire	전부
all~, entire	온
allergy	알레르기
all, everyone	모두
alley	골목
alley	골목길
all night, during the night	밤새
all the time	쭉
all, whole	다
all without exception	빠짐없이
almost, nearly	거의
almost, nearly	하마터면
alone	혼자
a long ago, olden days	옛날
a lot of, many	많이
already	벌써
already	이미
already, so soon	어느새
also	또한
alumni	동창
alumni association	동창회
always	늘
always	항상
always	내내
always, anytime	언제나
among them	그중
amount of money	금액
amount, sheep	양
an anxious feeling	불안감
ancestor	조상
ancestral rites, memorial service	제사
and	및
and	그리고
and then	그러자
and then	그러다가
a neighbor, the house next door	옆집
angel	천사
anger	화
angry	화나다
an ideal type of person	이상형
animal	동물
(animal) feed	먹이
~ animal(s), ~ head(s)	마리
ankle	발목
anniversary	기념일
anniversary/annual~	주년
announcement, notice	안내문
announcement, presentation	발표
announcer	아나운서
annual, every year	해마다
annual fee	연회비
annually, every year	매년
another, other	딴
answer	답
answer	대답
answer	답변
answer, reply	대답하다
antipyretic	해열제
an unmarried and old woman	노처녀
an unmarried, single person	미혼
an unmarried, single person	독신자
anxiety	불안
anxiety, concern	걱정
any	아무
anyhow, whatever	아무래도
any sort of, in any way	아무런
anyway	아무튼
anyway	어쨌든
any, what	아무것
apartment, mansion	아파트
appear	나타나다
appearance	모습
appearance	외모
appearance	겉모습
appearance	생김새
appetite	식욕
appetite	입맛
appetite, the taste of rice	밥맛
apple	사과
applicant	신청자
applicant	희망자
application	원서
application forms	신청서
appointment, promise	약속
appreciation	감상
appreciation gift, gift	사은품
appropriately	적당히
April	사월
aptitude (for)	적성
Arabic	아랍어
architect	건축가
architecture	건축
archive, reference room	자료실
area	영역
area	지역
Arirang (Korean traditional song)	아리랑
army	군대
around	주변
around	주위
around (the time)	무렵
arrival	도착
arrive	도착하다
art	미술
art	예술
art gallery, art museum	미술관
article, driver, engineer	기사
artist, painter	화가
as expected	과연
as expected, after all	역시
Asia	아시아
as if, just like	마치
as it is	그대로
ask	묻다
ask	물어보다
ask a question	질문하다
as much as one wants	실컷
as much as one wants	마음껏
as much as possible	되도록
as one wishes	마음대로
assertion, captain	주장
assistant	조교
as soon as possible, immediately, quickly	하루빨리
a stingy person	구두쇠
at a glance	한눈
athlete	운동선수
at its peak, in bloom	한창
at least	적어도
ATM	인출기
atmosphere	분위기
at once, together	한꺼번에
attach, stick	붙이다
attempt, trial	시도
attendance	출석
attendance, participation	참석
attention, interest	관심
at this time	이때
attitude	태도
attraction	매력
audience	관객
audience	관람객
audience	방청객
audience, viewer	시청자
August	팔월
aunt	큰어머니
aunt	작은어머니
Australia	호주
author	글쓴이
automatic	자동
autumn, fall	가을
autumn leaves, maple	단풍
avalanche	눈사태
a value (won coin)	짜리
average	평균
a very hot night	열대야
a visit to a sick person	문병
a visit to a sick person	병문안
a word	한마디
azalea	진달래
baby	애기
baby, toddler	아기
back gate	뒷문
back gate	후문
background	배경
background, foundation	바탕
backpack	배낭
backpack trip	배낭여행
back seat	뒷자리
bad	나쁘다
bag	가방
bag	봉지
bake	굽다
baked bread with red beans inside (street food)	붕어빵
bakery	빵집
balance	잔액
ball	공
ballet	발레
balloon	풍선
ballpoint pen	볼펜
bamboo, porridge	죽
ban	금지
banana	바나나
bank	은행
bank account	계좌
bank book, (deposit) passbook	통장
bank clerk	은행원
(bank) deposit	예금
bar	술집
barber	미용사
barefoot	맨발
bare hands	맨손
barely, finally	겨우
barrel, ~ package(s)	통
baseball	야구
basic	기본
basic, fundamental	기초
basket	바구니
basketball	농구
bath, bathing	목욕
bathroom	욕실
batteries	건전지
battery	배터리
beach	바닷가
beach	해수욕장
bean, soy	콩
bean sprouts	콩나물
bear	곰
beast	짐승
beautiful	곱다
beautiful	아름답다
beautiful woman	미인
beauty salon	미용실
be blocked, be clogged	막히다
be born	태어나다
be careful, warn	조심하다
because	왜냐하면
because, for ~, so~	때문
be changed	바뀌다
become	되다
be considered, it seems~	생각되다
bed	침대
bedroom	침실
beef	소고기
beef	쇠고기
beer	맥주
be excused	실례하다
be, exist (honorific form)	계시다
be few, write down	적다
before	이전
before and after	앞뒤
be full (I am full.)	배부르다
beg, ask	부탁하다
begin	시작되다
beginner	초보자
beginner-level	초급
beginning, start	초기
be good, friendly	착하다
be healthy	건강하다
behind, back, towards the rear	뒤쪽
behind story	뒷이야기
Beijing	베이징
be impressed	감동하다
being active	활동적
being as a result	결과적
being attractive	매력적
being a younger, younger person	연하
being carnivorous	육식
being characteristic	개성적
being commercial	상업적
being comparative	비교적
being cultural	문화적
being daily	일상적
being direct	직접적
being discharged from hospital	퇴원
being eco-friendly	친환경
being economic	경제적
being effective	효과적
being efficient	효율적
being enthusiastic, being active	적극적
being exotic, being foreign	이국적
being family-oriented	가족적
being famous	유명
being fantastic	환상적
being fundamental, being basic	기본적
being global, being worldwide	세계적
being historical	역사적
being human	인간적
being impressive	인상적
being in charge	담당
being indirect	간접적
being long term	장기적
being medical	의학적
being mental	정신적
being modern	현대적
being national	전국적
being natural	자연적
being natural, being automatic	저절로
being negative	부정적
being normal	정상적
being not enough, lacking	부족
being objective	객관적
being open	개방적
being ordinary	일반적
being overall	전체적
being paid, being charged	유료
being passive	소극적
being personal	개인적
being planned, as planned	계획적
being positive, being affirmative	긍정적
being practical	실용적
being professional	전문적
being provocative, being stimulating	자극적
being realistic	현실적
being regular	규칙적
being regularly	정기적
being representative, being typical	대표적
being scientific	과학적
being selfish	이기적
being shy	내성적
being sociable	사교적
being social	사회적
being special	특별
being specific	구체적
being the same	동일하다
being the same, in the same manner	마찬가지
being traditional	전통적
be kind	친절하다
bell	벨
belly button	배꼽
belongings	준비물
belongings when moving house	이삿짐
belt	벨트
belt, waistband	허리띠
be nervous	긴장되다
be okay	괜찮다
be opened	열리다
be shaved, be pushed	밀리다
besides, differently	달리
besides, in addition	게다가
best	최선
best, the highest	최고
be surprised	놀라다
bet, call	걸다
between, while	사이
beverages, drink	음료
be written, be used	쓰이다
Bibimbap, mixed rice	비빔밥
bicycle	자전거
big brother (honorific form)	형님
big city	대도시
big, large	크다
big money	큰돈
big voice, loud voice	큰소리
billion	억
binge eating	폭식
biological mother	친어머니
bird, new	새
birth	출생
birthday	생일
birthday (honorific form)	생신
birth rate	출산율
black	검다
black	검은색
black	까맣다
blackboard	칠판
black color	까만색
black tea	홍차
blanket	이불
blind	블라인드
blind date	미팅
blind date	소개팅
blind person	맹인
blog	블로그
blood	피
bloom	피다
blouse	블라우스
blow (wind or whistle, musical instruments, etc.)	불다
blue	파랗다
blue color	파란색
blue jeans	청바지
boarding gate	탑승구
boarding house, lodging house	하숙
boarding house, lodging house	하숙집
boast, brag, showing off	자랑
body	몸
body	신체
body temperature	체온
bodyweight	체중
bodyweight	몸무게
boil	끓이다
bonus	보너스
book	책
~ book(s)	권
books	도서
bookshelf	책장
bookstore	서점
bookstore	책방
borrow, lend	빌리다
botanical garden	식물원
both	양쪽
bottom, below	밑
bottom, floor	바닥
bottom, under	아래
bouquet	부케
bowl, container, tableware	그릇
bowling	볼링
bowling gym	볼링장
box	상자
box	박스
braised dish	조림
brake	브레이크
branch	가지
brand	브랜드
Brazil	브라질
bread	빵
breakfast	아침밥
breakfast	아침식사
break-out room, lounge	휴게실
brick	벽돌
bride, father (christianity)	신부
bridge, leg, foot	다리
bright	밝다
bring	가져오다
bring, take along	데리다
broadcast	방송
broadcasting company	방송사
broadcast stations	방송국
broken, malfunction	고장
brother (as seen from the younger brother)	형
brother (as seen from the younger sister)	오빠
brother, sister	동생
brown	갈색
bruise	멍
bubble	거품
buddhism	불교
buddhist monk	스님
buffet	뷔페
build, create	짓다
build, frame	체격
building	건물
building	빌딩
Bulgogi, grilled meat	불고기
bulletin board	게시판
bunch, flower, cluster	송이
burden, pressure	부담
burn, scald	화상
bus	버스
Busan	부산
business	사업
business	장사
business administration	경영학
business trip	출장
busy	바쁘다
but, however	그러나
but, however	하지만
(but) still	그래도
butt	엉덩이
button	버튼
buy	사다
buzzword	유행어
by any chance	만약
by oneself	스스로
by the way	근데
by the way, however	그런데
cabbage	배추
cafe, coffee shops	카페
café, teahouse	찻집
caffeine	카페인
cake	케이크
calculate	계산하다
calculation, accounting	계산
calendar	달력
call, sing	부르다
camera	사진기
camera	카메라
camping	캠프
campus	캠퍼스
Canada	캐나다
cancel	취소하다
cancer	암
candidate	후보
candy	사탕
~ can not do	못하다
capital, hub	중심지
capital, water supply	수도
car, automobile	자동차
car company	자동차회사
card	카드
career	경력
carelessness	부주의
cargo	화물
carnation	카네이션
carpet	카펫
car rental	렌터카
car repair shop	카센터
carrot	당근
car, tea	차
cartoon book	만화책
case, circumstance	경우
case, example	사례
cash	현금
cashier	계산대
cassette	카세트
castle, last name	성
casual talk	반말
cat	고양이
catch, grab, hold	잡다
catholic church	성당
cause	원인
caution	주의
caution, carefulness	조심
cave	동굴
CD	시디
ceiling	천장
celebrate	축하하다
celebration	축하
celebrity	연예인
cell phone, mobile phone	핸드폰
cell phone, mobile phone	휴대전화
center	센터
center	중심
centimeter	센티미터
central part	중부
central part	중앙
century	세기
CEO, the president	사장
certificate	증명서
chair	의자
chairperson	진행자
challenge	도전
chance, accident	우연
change	변화
change	바꾸다
change	거스름돈
change, alter	변경
channel	채널
~ chapter(s), ~ sheet(s)	장
character, Here we go.	자
characteristic, feature	특징
chatter, make a noise	떠들다
cheap thing	싸구려
cheap, wrap	싸다
check, bill	계산서
cheek	뺨
cheerfulness, brightness	명랑
cheering, support	응원
cheers, toast	건배
cheese	치즈
chef	요리사
cherry blossom	벚꽃
chest, breast	가슴
chew, bite	씹다
chewing gum	껌
chicken	닭고기
chicken, hen	닭
child	애
child	아이
child	아동
child	자녀
child	어린이
childcare	육아
child, kid	자식
children	어린아이
children's book	동화책
Children's day	어린이날
China	중국
Chinese	중국어
Chinese character	한자
Chinese cuisine	중식
Chinese restaurant	중국집
chip, crack, break	깨지다
chocolate	초콜릿
choose	고르다
choose, establish	정하다
choose, select	선택하다
chop, cut	썰다
chopsticks	젓가락
chopsticks and a spoon	수저
Christmas	크리스마스
chrysanthemum	국화
church	교회
Chusoku (Korean Thanksgiving Day)	추석
cider	사이다
circumstances, situation	사정
citizen	시민
citizens	국민
city	도시
city hall	시청
city, time	시
civilization	문명
clap, applause	박수
class, grade	급
classic	클래식
classification	구분
class, lesson	수업
classroom	교실
(class) subject	과목
clean	깨끗하다
clear, clean	맑다
clearly	깨끗이
clearly, explicitly	분명히
clerk	점원
click	클릭
client, customer	고객
climate	기후
climb	오르다
clock	시계
close	닫다
close	가깝다
close ~ (eyes)	감다
close, familiar	친하다
closet	옷장
clothing	의류
clothing, costume	의상
clothing, food, and housing	의식주
clothing store	옷가게
cloud	구름
cloudy	흐리다
club	동호회
club, group	동아리
coal	석탄
coat	코트
coffee	커피
coffee shop	커피숍
coin	동전
coincidentally	우연히
coincidentally	어쩌다가
Coke	콜라
cold	감기
cold	춥다
cold	추위
cold	차갑다
cold medicine	감기약
cold noodle	냉면
cold water	찬물
colleague	동료
collect, gather	모으다
collection	수집
college student	대학생
collision	충돌
color	색
color	색깔
color	색상
column, blank	칸
come	오다
come back, come home	돌아오다
comedian	코미디언
come down	내려오다
comedy	코미디
come in, enter	들어오다
come out, appear	나오다
come to visit	찾아오다
come up	올라오다
come with, follow	따라오다
comfortable, easy, convenient	편하다
comic book, cartoon	만화
commemoration	기념
commerce	상업
commission, fee, charge	수수료
common	공통
common knowledge, common sense	상식
commonly, often	흔히
common point	공통점
communication	연락
communication	통신
communication	의사소통
community life	공동생활
commuting	출퇴근
company	회사
company, corporation	기업
comparison	비교
compassion, understanding	이해심
competition	경쟁
competition, game	경기
competition, match	시합
competition, tournament	대회
competitiveness	경쟁력
complaints	불평
completely	완전히
completion	완성
completion ceremony	수료식
complexion	안색
complicated, crowded	복잡하다
compliment	칭찬
composition	구성
composition	작곡
comprehension, understanding	이해력
computer, PC	컴퓨터
computer room	전산실
computer room	컴퓨터실
concentration	집중
concentration	집중력
concert	연주회
concert	콘서트
conclusion	결론
conclusion	마무리
condiments, seasoning, spice	양념
conditions	조건
conductor	지휘자
conference	회의
conference hall	회의장
confession	고백
confidence	자신감
confirm, check	확인하다
conflict	갈등
confusion, mess, disorder	혼잡
congratulations	축하합니다
connection	연결
consecutive holidays	연휴
consideration	배려
consolation, comfort	위로
consonant	자음
constipation	변비
construction	건설
construction	공사
consultant	상담자
consultation, counseling	상담
consultation, discussion	의논
consumer	소비자
consumption	소비
contact information	연락처
content	내용
content (of a container)	내용물
continue	계속
continuity	연속
contract	계약
control, regulate (illegal action)	단속
convenience	편리
convenience store	편의점
conversation, dialogue	대화
cooked rice	쌀밥
cooking	조리
cooking, cuisine	요리
cooking oil	식용유
cool, nice	멋있다
cool, refresh	시원하다
copy	복사
copy machine	복사기
corner	코너
corporation	주식회사
correct answer	정답
corridor, hallway	복도
cosmetics	화장품
cost	비용
cost of living, living stipend	생활비
cough	기침
counseling room	상담실
counselor	상담원
countermeasures	대책
country	나라
countryside	시골
couple	연인
couple	커플
couple, husband and wife, married couple	부부
courage	용기
court of law	법원
cousin	사촌
cover	덮다
crack, gap	틈
crane	학
credit, trust	신용
crime	범죄
criminal, offender	범인
crops	농작물
cross (a road)	건너가다
cross over	건너다
crosswalk	횡단보도
cruise ship	유람선
crush, one side love	짝사랑
cry	울다
crybaby	울보
crying, tear	울음
cucumber	오이
cultivate, grow	기르다
cultural heritage	문화유산
cultural life	문화생활
culture	문화
cup	컵
curiosity	궁금증
curiosity	호기심
currency exchange	환전
curry	카레
curtain	커튼
customer	손님
cut	자르다
cute	귀엽다
cut, shave	깎다
cutting line/que	새치기
cyber	사이버
dad	아빠
daily life	일상
daily necessities	생필품
damage	피해
dance	춤
dance	무용
dance	추다
dance	댄스
dance	춤추다
dangerous	위험하다
dark	어둡다
date	날짜
date, dating	데이트
daughter	딸
daughter-in-law	며느리
dawn, late at night, early morning	새벽
day	날
day before yesterday	그저께
day by day	날로
day by day	나날이
day by day	하루하루
day, noon, during the day	낮
day of the week	요일
deadline, due date	마감일
death	사망
death	죽음
debt	빚
December	십이월
decide	결정하다
decision	결정
decision	결심
deeply	푹
deer	사슴
defective product, misconduct	불량
definitely	틀림없이
definitely, absolutely	절대로
degree	정도
delay, postponement, smoke, acting	연기
delicious	맛있다
delivery	배달
delivery	택배
delivery, conveyance	전달
delivery fee	택배비
dentist, dentistry	치과
depart	출발하다
department	부서
department (at university)	학과
department store	백화점
depends on	나름
deposit	보증금
deposit, payment on account	입금
depression	우울증
depth	깊이
dermatology	피부과
desert	사막
design	디자인
designer	디자이너
desk	책상
dessert	후식
destination	목적지
detergent	세제
developed country	선진국
development	발전
development	개발
development	발달
devoted daughter	효녀
dialect	사투리
diary	일기
diary	일기장
dictionary	사전
die	죽다
diet	식생활
diet	다이어트
difference	차이
differences	차이점
different	다르다
difficult	어렵다
difficulty	곤란
difficulty, hardship	어려움
digestion	소화
digital	디지털
diligent	성실
diligent	부지런하다
dinner	석식
dinner	저녁식사
dinner, evening, night	저녁
diplomat	외교관
dip, pickle	담그다
direction	방향
directly, direct	직접
director	부장
director	감독
dirty	더럽다
disability	장애
disabled people	장애인
disadvantage, shortcoming, drawback	단점
disappearance, missing	실종
disappointment	실망
disaster	재해
disc, hernia	디스크
discount store	할인점
discovery	발견
discussion	토론
disease	질병
disease	질환
dislike, hate	싫어하다
display board	표지판
disposable product	일회용품
disregard, neglect	무시
dissatisfaction	불만
distinction	구별
division	과
divorce	이혼
doctor	의사
doctoral degree, Ph.D.	박사
doctor of traditional Korean medicine	한의사
document	서류
documents	문서
dog, ~ piece(s)	개
doll	인형
dollar	달러
domestic	국내
domestic flights	국내선
donation	기부
Dongdaemun market	동대문시장
do not know	모르다
doodle	낙서
door, gate	문
door, gate	대문
dormitory	기숙사
do, say	하다
doubt	의심
do well, good at	잘하다
down payment	계약금
downtown, city, stream	시내
dragon	용
dragonfly	잠자리
drama	드라마
draw	그리다
drawer	서랍
drawing lots	추첨
drawing, picture	그림
dream	꿈
dream	꾸다
dream	드림
dress, clothes	옷
dress, clothing	옷차림
dressing room, fitting room	탈의실
drink	마시다
drinking	음주
drinking party	술자리
drink, soft drink	음료수
drive	운전하다
driver	운전자
driver	운전기사
driver's license	운전면허
drop	떨어지다
drought	가뭄
drug	마약
dry	건조
dry	마르다
dry	드라이
dry cleaners, laundromat	세탁소
dual-income family	맞벌이
duck	오리
dumpling	만두
during, between	동안
dust	먼지
duty-free shop	면세점
DVD	디브이디
dyeing	염색
each	각
each, every, per	씩
each one	각자
each other, both	서로
eagerly	간절히
eagerly, diligently	부지런히
ear	귀
earlier, while ago	아까
early	일찍
earn, make money	벌다
earphone	이어폰
earrings	귀걸이
earth	지구
earthquake	지진
easily	편히
easily, anytime soon	좀처럼
east	동쪽
east coast	동해안
eastern and western	동서양
eastern, orient	동양
eastern part	동부
easy	쉽다
eat	먹다
eat (honorific form)	드시다
eat (honorific form)	잡수시다
eating habits	식습관
eating out	외식
economic depression	불경기
economic power	경제력
economics	경제학
economy	경제
education	교육
educational background	학력
educator	교육자
effect	효과
effort	노력
egg	계란
egg	달걀
egg, ball	알
Egypt	이집트
elderly	노인
elderly and physically handicapped	노약자
elder, senior	선배
eldest daughter	맏딸
eldest daughter	장녀
eldest son	장남
eldest son	맏아들
electrical outlet, socket	콘센트
electric car	전기자동차
electricity	전기
electron	전자
electronic dictionary	전자사전
electronic transfer, ATM deposit	무통장 입금
elementary school	초등학교
elementary student	초등학생
elephant	코끼리
elevator	승강기
elevator	엘리베이터
e-mail	메일
e-mail	이메일
embassy	대사관
embrace, cradle	안다
emergency medicine	비상약
emergency room	응급실
emotion	감정
emphasis	강조
employee	종업원
employee	회사원
employee, staff	직원
encounter, meeting	만남
encouragement	격려
end	끝
endeavor, strive	노력하다
end (of a story)	결말
end of month	월말
end of the year	연말
enemy	적
energy	에너지
energy, qi	기운
engagement	약혼
engine	엔진
English	영어
English conversation	영어회화
enjoy, have fun	즐기다
enough	충분하다
enough, sufficiently, fully	충분히
enrollment	재학
entertainers	탤런트
entertainment	오락
entire	전체
entrance	입구
entrance	현관
entrance door	현관문
entrance examination	입시
entrance examination	입학시험
entrance to a higher educational institution	진학
entrepreneur	기업인
entrepreneur, businessman	사업가
entry	가입
envelope	봉투
environment	환경
equal	평등
era, generation	시대
eraser	지우개
errand	볼일
errand	심부름
especially	특별히
especially, in particular	특히
essay, writing	작문
etc, back	등
eternally, everlastingly, forever	영원히
ethnic group	민족
Europe	유럽
evaluation	평가
even if	비록
even if, for example, diarrhea	설사
evenly	골고루
even more	더욱
even number	짝수
event	행사
event hall	행사장
everyday	매일
everyday life	일상생활
everyone, ladies and gentlemen	여러분
every week	매주
exactly, absolutely	꼭
examinee	응시자
example, model sentence	예문
example, sample	보기
exam, test	시험
exceed, more than	넘다
excellence	우수성
except, besides	이외
excessive air conditioning syndrome	냉방병
excessive drinking	과음
exchange	교환
exchange rate	환율
excitement	흥분
excuse	실례
excuse	변명
excuse	핑계
executive, CEO	경영자
exercise	운동
exercise	운동하다
exhibition	전시
exhibition	전시회
exit	출구
expectation	기대
expectation	예상
expense, spending	지출
expensive	비싸다
experience	경험
experience	체험
experiment	실험
expert	전문가
explain	설명하다
explanation, description	설명
explosion	폭발
export	수출
express bus	고속버스
expression	표현
extension	연장
extreme heat (in summer)	무더위
extremely, to a great extent	굉장히
extremely, very	매우
eyebrow	눈썹
eye disease	눈병
eye drop	안약
eye-level	눈높이
eye, snow	눈
face	얼굴
facial expression	표정
facility	시설
fact	사실
factory	공장
failure	실패
fairly, pretty	상당히
fairy tale	동화
fall down, fall	넘어지다
fallen leaves	낙엽
familly	식구
family	가족
family	가정
family	집안
famous	유명하다
famous place	명소
fan	팬
fan	부채
fan	선풍기
far away	멀리
far, distant, long	멀다
farewell	이별
farewell party	환송회
farmer	농민
farmer	농부
(farm) field	밭
fashion	패션
fashion show	패션쇼
fast	빠르다
fast food	패스트푸드
fate	운명
father	아버님
father	아버지
father-in-law	시아버지
fatigue	피로
fat, region	지방
favor	호감
favor, grace	은혜
fax	팩스
fear	겁
fear	공포
fear	두려움
February	이월
fee	요금
feel	느끼다
feeling	기분
feeling	느낌
female	여성
female student	여학생
fermented soybean paste	된장
festival	축제
fiance	약혼자
(field of) medicine	의학
field, ~s,	들
fight	싸움
fight	싸우다
file	파일
film	필름
film director	영화감독
film festival	영화제
filming site	촬영지
final game/round	결승전
finally	드디어
finally	마침내
finally, eventually	끝내
finally now	이제야
find, visit	찾다
fine	벌금
finger	손가락
finish	끝내다
finish, end	끝나다
finish, end	마치다
fire	화재
fire department	소방서
fire, electrical light	불
firefighter	소방관
firetruck	소방차
firework	불꽃놀이
first	첫
first	우선
first	첫째
first day	첫날
first, first of all, before	먼저
first, for the first time	처음
first half	전반전
first impression	첫인상
first love	첫사랑
first of all, firstly	일단
first place	일등
first snow	첫눈
fish	생선
fish	물고기
fishing	낚시
fist	주먹
fit, appropriate	알맞다
fix	고치다
flame, light	불빛
flavor, taste	맛
flea market	벼룩시장
flesh, ~ year(s) old	살
flight	항공
flight	항공편
flight ticket	항공권
flood	홍수
florist	꽃집
flour	밀가루
flower	꽃
flowerpot	화분
flower vase	꽃병
fog	안개
folklore	민속
folk play	민속놀이
folk song	민요
folk village	민속촌
follow	따르다
follow	따라가다
food	식품
food	먹을거리
food and drink	음식물
food, cooking	음식
food expenses	식비
football, soccer	축구
foot, leg	발
footprints	발자국
footsteps	발걸음
for a bit, for a while, a little	잠시
for a long time	한참
for a long time	오랫동안
for a moment	한순간
for a while, a little	잠깐
for a while (from now on)	당분간
forcibly	억지로
forecast	예보
forecast	예측
forehead	이마
foreign country	외국
foreigner	외국인
foreign language	외국어
foreign student, international student	유학생
forest	숲
forest fire	산불
forever	평생
forget	잊다
forget	잊어버리다
forgetfully, with a blink	깜빡
forgetfulness	건망증
forgiveness	용서
for, in favor of, for the sake of	위하다
form	형태
formal clothes, suits	정장
form, arise	생기다
formula, method	식
form, western style	양식
for no reason	괜히
for some reason	왠지
for some reason, What was it?	웬일
forsythia	개나리
fortunately	다행히
fortune	복
fortune, luck	다행
fountain pen	만년필
four days	나흘
four seasons	사계절
fourth	넷째
fragrance	향기
France	프랑스
free	공짜
free	무료
freedom	자유
frequently	자꾸
freshmen	신입생
Friday	금요일
fried rice	볶음밥
friend	친구
friendship	우정
frog	개구리
from time to time, sometimes	종종
front door, main gate	정문
front, previous	앞
fruit	과일
frustration	짜증
frustration, regret	아쉬움
fry	볶다
frying pan	프라이팬
full	가득
full moon	보름달
full, much	잔뜩
fun, be pleasant	즐겁다
function	기능
funeral	장례식
funeral hall	장례식장
funny, make someone laugh	웃기다
furniture	가구
furniture store	가구점
furthermore, moreover	더구나
future	미래
future	앞날
future	장래
gain, increase	늘다
Galbitang, spareribs soup	갈비탕
Galvi, spareribs	갈비
game	게임
game machine	게임기
game of go	바둑
game of Yut, Yunnori	윷놀이
Gamjatang, potato soup	감자탕
garbage	쓰레기
garbage recycling	분리수거
garden	마당
garlic	마늘
gas	가스
gasoline	휘발유
gas station	주유소
gather, get together	모이다
gender	성별
gender equality	남녀평등
general affairs division	총무과
generation	세대
genius, natural disaster	천재
Germany	독일
gesture	몸짓
get a job	취직하다
get angry	화내다
get caught, take (time)	걸리다
get married	결혼하다
get up, stand up	일어서다
ghost	귀신
gift certificate	상품권
gift, present	선물
Gimpo International Airport	김포공항
ginger tea	생강차
ginseng	인삼
girlfriend	그녀
give	주다
give	드리다
giving birth	출산
glad, delight	기뻐하다
glance, attention	눈길
glass	유리
glass, ~ cup(s)	잔
glasses	안경
glasses, cup	술잔
gloves	장갑
go	가다
go, commute	다니다
god, new	신
go down	내리다
go down	내려가다
go in, enter	들어가다
going straight	직진
gold	금
gold medal	금메달
golf	골프
good	좋다
go out	외출하다
go out, get out	나가다
go to visit	찾아가다
go to work	출근하다
go up	올라가다
gourd	바가지
government	정부
grace, blessing	혜택
grade, credit	학점
grade report card	성적표
grades	성적
grade, school year	학년
gradually	점차
gradually	서서히
gradually, slowly	점점
graduate	졸업하다
graduate school	대학원
graduation	졸업
graduation ceremony	졸업식
gram	그램
grammar	문법
grandfather	할아버지
grandmother	할머니
grandson	손자
grape	포도
graph	그래프
grass	잔디
grass field	잔디밭
greatly	대단히
greed	욕심
greedy person	욕심쟁이
green	녹색
green color	초록색
green tea	녹차
greet	인사하다
greeting	맞이
greetings	인사
greeting words	인사말
grey	회색
grill	구이
grilled pork belly	삼겹살
grocery	식료품
groom	신랑
groom candidate	신랑감
group	그룹
group	단체
group dinner, drinking party	회식
growth, rise	증가
guess	추측
guest room	객실
guidebook, handbook	안내서
guide, invite	안내하다
gun	총
guy	놈
Gyeongbokgung	경복궁
Gyeongju	경주
gym	체육관
gymnastics	체조
habit	습관
habit, manner	버릇
hair	머리카락
(hair) bangs	앞머리
hairstyle	헤어스타일
half	절반
half a year	반년
half, group	반
half-moon	반달
hamburger	햄버거
Hanbok, Korean traditional clothes	한복
hand	손
handbag	핸드백
handkerchief	손수건
handle, rail	손잡이
hands and legs	손발
handshake	악수
handsome	잘생기다
Hangul	한글
Hangul day	한글날
Hanok (traditional Korean architecture)	한옥
Han River, Hangang	한강
happiness	행복
happy	기쁘다
happy	행복하다
hard, enthusiastic	열심히
hardship	고생
hardship, hard work	수고
hat	모자
hate	싫다
have	갖다
have	가지다
have a sale	세일하다
have fun	즐거워하다
have, there	있다
headache	두통
headache pill/medicine	두통약
head, hair	머리
head, hill	고개
health	건강
healthy diet	건강식
healthy food	건강식품
heart	심장
heart disease	심장병
heater	난방
heat, hotness	더위
heaven	천국
heavy	무겁다
heavy rain	폭우
heavy snow	폭설
hectically, frantically	정신없이
height	높이
hell	지옥
hello	여보세요
hello	안녕하십니까
helmet	헬멧
help	돕다
help	도와주다
help, assistance	도움
hence	그러므로
here	여기
here and there	여기저기
here and there	이리저리
here and there, everywhere	곳곳
hierarchy	계층
high	높다
high grade	고급
highlights/fun things to see	볼거리
high school	고등학교
high school girl	여고생
high school student	고등학생
high speed	고속
highway	고속도로
hi, hello	안녕하세요
hiking boots, climbing shoes	등산화
hiking, mountain-climbing	등산
his, the person	그분
historic site	유적지
history	역사
hobby	취미
hold, enter	들다
hole	구멍
holiday	휴일
holidays, annual events	명절
holiday season	휴가철
home appliances	가전제품
home page	홈페이지
homeroom teacher	담임
hometown	고향
homework	숙제
honestly, frankly	솔직히
honey	꿀
honey bee	꿀벌
honeycomb	벌집
honeymoon	신혼여행
honorifics	높임말
honor prize	우등상
hope	소망
hope	희망
hope	바라다
hospital	병원
hospitality	대접
hospitalize	입원하다
hosting (an event)	개최
hot	덥다
hot	뜨겁다
hotel	호텔
hotel, inn	여관
hot spring	온천
hot spring bath	온천욕
hot water	더운물
house	댁
housecleaning	대청소
household account book	가계부
house price	집값
house, shop	집
housewarming party	집들이
housewife	주부
housework	가사
housework	집안일
housing, residence	주택
how	어떻게
how	어떻다
How is it?	어떻습니까?
how much	얼마나
how on earth	도대체
(how to count trees), stump	그루
how to use	사용법
human	인간
human nature	인간성
human race	인류
humid heat	찜통더위
humidifier	가습기
humidity	습도
humility	겸손
humming	콧노래
humor	유머
hungry	고프다
hungry	배고프다
hurry, quickly	어서
hurry, urgent	급하다
hurt	다치다
husband	남편
I	나
I	내가
I	제가
ice	얼음
ice cream	아이스크림
idea	아이디어
identification document	신분증
identity	정체
idiom	관용어
idiot, stupid	바보
I do not know., well, I guess ~	글쎄요
I don't know.	모르겠습니다
if, should	만일
illegal	불법
illness, ~ bottle(s)	병
image	이미지
imagination	상상
imagination	상상력
immediately after	직후
immediately, for now	당장
immediately, soon, just	바로
immigrants	이민
immigration	출입국
impact	영향
implementation	실시
importance	중요
importance	중요성
important	중요하다
important matter	큰일
import, income	수입
impossibility	불가능
impression	인상
improvement	개선
I'm sorry.	미안합니다
in addition, again	또
in advance, beforehand	미리
Incheon	인천
incident	사건
income	소득
inconvenience	불편
independence	독립
in detail	자세히
India	인도
indifference	무관심
individual	개인
individuality	개성
indoor	실내
indoor floor	마루
industry	산업
in fact, actually	실은
in fact, actually	실제
in fact, actually	실제로
influenza, flu	독감
inform	알리다
information	정보
information office	안내소
informatization	정보화
in full bloom	활짝
injection	주사
injured person	부상자
injury	부상
inquiry	문의
insanely, do something without any order	막
inside	속
inside	안쪽
inside, internal	내부
insomnia	불면증
inspection	검사
installment savings	적금
instant food	인스턴트
in substitute	대신
insurance	보험
insurance fee	보험료
insurance money	보험금
intercity bus	시외버스
interest	이자
interest	흥미
interesting	재미있다
interference, interruption	방해
intermediate	중급
intern	인턴사원
internal medicine	내과
international	국제
international flights	국제선
international marriage	국제결혼
internet	인터넷
interpretation	통역
interpretation	풀이
intersection, four corners	사거리
intersection, three-way intersection	삼거리
interval	간격
interview	면접
interview	인터뷰하다
interviewer	면접관
interview test	면접시험
introduce	소개하다
introduction	소개
introduction	서론
introspection, self-contemplation	반성
invention	발명
investigate	조사하다
investment techniques	재테크
invitation	청첩장
invitation	초대장
invitation	초청장
invite	초대하다
invoice	청구서
iron	쇠
ironing	다림질
iron, season	철
irregularity	불규칙
is	이다
island	섬
issuance	발급
it	그
it	그거
it	그것
It's fine.	괜찮습니다
I understood.	알았습니다
jacket	재킷
jacket	점퍼
Jajangmyeon	자장면
January	일월
Japan	일본
Japanese drama	일본드라마
Japanese food	일본요리
Japanese language	일본말
Japanese language	일본어
Japanese people	일본사람
Japanese style, Japanese food	일식
Japchae (Korean food)	잡채
jazz	재즈
jealousy	질투
Jeju Island	제주도
job, profession	직업
jogging	조깅
joint	공동
joke	농담
Jong-ro	종로
Jordan	요르단
journalist	언론인
joy, happiness	기쁨
joy, pleasure	즐거움
juice	주스
July	칠월
June	유월
Junior	후배
just	그저
just, as it is	그냥
just as it was before	여전히
just happened to be	마침
justice	정의
just now	방금
Karaoke shop	노래방
key	열쇠
key, height	키
kick	차다
kilogram	킬로그램
kilometer	킬로미터
Kimbab	김밥
Kimchi	김치
Kimchi stew	김치찌개
kindergarten	유치원
kind, type	종류
king	왕
kitchen	부엌
kitchen	주방
knee	무릎
knife, cutlery, swords	칼
know	알다
knowledge	지식
Kochujang, red pepper paste	고추장
Korea	한국
Korean beef	한우
Korean cold noodle	물냉면
Korean cuisine	한식
Korean cuisine	한국요리
Korean drama	한국드라마
Korean independence movement day	삼일절
Korean language	국어
Korean language	조선말
Korean language	조선어
Korean language	한국말
Korean language	한국어
Korean language	우리말
Korean pancake	파전
Korean people	한국사람
Korean set meal	한정식
Korean studies	한국학
Korean style chicken dish	닭갈비
Korean style cold noodles with spicy sauce	비빔냉면
Korean style noodle	칼국수
(Korean style) seasoned vegetables	나물
Korean style shaved ice	팥빙수
(Korean traditional) candy	엿
Korean traditional mask dance	탈춤
label	상표
labor	노동
laboratory	실험실
laborer	노동자
lake	호수
lamp	램프
lamp, light	전등
land, ground	땅
landlord	집주인
landscape	풍경
language	어학
language	언어
language training	어학연수
laptop	노트북
large company	대기업
large size	대형
last	마지막
last, final	최종
last, final	최후
last month	지난달
last night	어젯밤
last time	지난번
last train	막차
last week	지난주
last year	작년
last year	지난해
late, delay	늦다
later	이따
later	이따가
later, after	나중
later half	후반
latest	최신
laugh	웃다
laughter	웃음
laundry	세탁물
laundry, wash	빨래
law	법
lawyer	변호사
layer, ~ floor	층
layoff, discharge	해고
leaf	잎
leaf	나뭇잎
learn	배우다
learning, study	학습
leave	남기다
leave	떠나다
leave of absence (from school)	휴학
leave the office	퇴근하다
leaving a country	출국
lecture	강좌
lecture	강연
lecture	강의
lecture hall	강의실
left	왼쪽
left and right	좌우
leisure	여가
leisure sports	레포츠
lemon	레몬
lens	렌즈
lenth	길이
less, not yet	덜
less than, below	이하
letter	편지
letter	글씨
letter	글자
letter of recommendation	추천서
level	수준
library	도서관
license	면허증
license, certificate	자격증
lie	거짓말
lie down, sleep	눕다
lies	거짓
life	삶
life	생활
life	목숨
life	생명
life	인생
lifespan	수명
lifetime	일생
light	빛
light	가볍다
light bulb	전구
lighting, illumination	조명
lights, lamp	등불
like	좋아하다
like that, in that way	저렇게
like that, so	그렇게
like this	이렇다
like this, so, in this way	이렇게
limit, restriction	제한
line	선
line, column, string	줄
lips	입술
liquid medicine	물약
listen	듣다
listening, hearing	듣기
literature	문학
live	살다
live broadcast	생중계
livestock	가축
living	살림
living alone	자취
living room	거실
load, baggage	짐
loan, lend	대출
loan word, borrowed word	외래어
lobby	로비
location, position	위치
lodge, a local hotel	민박
lodging, accomodating	숙박
loneliness	외로움
lonely	외롭다
long	길다
long, much	오래
long time	오랜
Long time no see.	오래간만입니다
look good on, befit	어울리다
lose	잃다
lose	지다
lose	잃어버리다
loss	분실
lost and found	분실물
lottery	로또
lottery	복권
love	사랑
love	사랑하다
love, affection	애정
love marriage	연애결혼
lover	애인
low	낮다
luck	운
luck, fortune	행운
lump-sum payment	일시불
lunar calendar	음력
Lunar New Year	설날
lunch	점심
lunch	점심식사
lunchbox	도시락
lunchtime	점심시간
machine	기계
magazine	잡지
magic	마술
mail delivery	우편배달
main character	주인공
main discussion topic	본론
mainly	주로
main road	큰길
major	전공
make, create	만들다
make cry, chime	울리다
make someone do, order	시키다
makeup	화장하다
male	남성
male student	남학생
man	남자
management	경영
management	관리
management room	관리실
manager	과장
mandarin orange	귤
mandatory	필수
mannequin	마네킹
manner, etiquette	예의
manner, etiquette	예절
manual	설명서
manuscript	원고
many	많다
many	다수
many	여럿
map	지도
marathon	마라톤
March	삼월
market	시장
marketing	마케팅
marriage	결혼
marriage (of men)	장가
marriage proposal	청혼
married	기혼
mask	마스크
mask, disguise	탈
mass, a large amount	대량
mass media	언론
masterpiece, designer goods	명품
master's bedroom	안방
master's degree	석사
material	재료
material, document	자료
maternal	외가
maternal aunt	이모
maternal aunt	외숙모
maternal grandfather	외할아버지
maternal grandmother	외할머니
maternal uncle	외삼촌
maternal uncle	이모부
mathematics	수학
maximum	최대
May	오월
maybe	혹시
maybe, perhaps	아마
maybe, possibly	어쩌면
meal	식사
meaning	뜻
meaning	의미
means, method	수단
meantime, meanwhile, up to now	그동안
meat	고기
medical examination	진찰
medium	매체
medium, during	중
meet	뵙다
meet	만나다
meeting, gathering	모임
melody	멜로디
melon	멜론
member	회원
membership fee	회비
membership training	엠티
memo	메모
memorial hall	기념관
memory	추억
memory	기억
memory	기억력
men and women	남녀
men and women of all ages	남녀노소
men's clothing	남성복
menu	메뉴
merchant	상인
message	메시지
meter	미터
method, style	방식
Mexico	멕시코
microwave	전자레인지
midday	한낮
middle	중간
middle	가운데
middle school, Junior high school	중학교
middle school student	중학생
milk	우유
millimeter	밀리미터
mind, consciousness	정신
mind, feeling	마음
mindfulness	마음씨
minimum	최저
minority, a small number	소수
minus, below zero	영하
mirror	거울
mischievous kid	장난꾸러기
misfortune	불행
Miss, daughter	아가씨
missing person	실종자
mistake	잘못
mistake, failure	실수
misunderstanding	오해
misunderstanding	착각
mobile	휴대
mobile phone	휴대폰
model	모델
model, figure	모형
model student	모범생
moderator, chairperson	사회자
modern people	현대인
modern style	현대식
moisture	습기
mom	엄마
moment	순간
Monday	월요일
money	돈
(money) check	수표
money transfer	송금
Mongolia	몽골
monkey	원숭이
month	월
monthly, every month	매달
monthly installment plan	할부
monthly rent	월세
monthly salary	월급
month, moon	달
moonlit night	달밤
mopping	걸레질
more	더
more and more	갈수록
more than, strange	이상
morning, a.m.	오전
morning and evening	아침저녁
morning, breakfast	아침
mosquito	모기
most	가장
most	제일
mostly, almost	대부분
mostly, usually	대개
mother	어머니
mother	어머님
mother-in-law	시어머니
motion, action	동작
motionlessly	가만히
motivation	의욕
motorcycle	오토바이
mountain	산
mountaineering clothing	등산복
mountain summit	산꼭대기
mouse	쥐
mouth	입
move	이동
move	움직이다
move, moving	이사
move, transfer, translate	옮기다
movie	영화
movie star	영화배우
movie theater	영화관
movie ticket	영화표
moving (emotionally)	감동적
Mt. Seorak	설악산
much, far, a lot	훨씬
multimedia room	시청각실
multimedia room	멀티미디어실
murder	살인
muscle	근육
museum	박물관
mushroom	버섯
music	음악
musical	뮤지컬
musical concert	음악회
musical instrument	악기
musician	음악가
myself, own	자기
myself, own	자신
Namdaemun market	남대문시장
name	성함
name	이름
name	호칭
name tag	이름표
narrow	좁다
nation	국가
nationalestablished, state	국립
nationality, country of citizenship	국적
nationwide	전국
native language	모국어
natural curly hair	곱슬머리
nature	자연
naughty child	개구쟁이
naughty, prank	장난
near	가까이
nearby, neighborhood	근처
necessities	필수품
necessity	필요
necessity	필요성
necklace	목걸이
neck, throat	목
necktie	넥타이
need	필요하다
needle	바늘
needlework	바느질
neighbor	이웃집
neighborhood	이웃
nephew	조카
nervousness	긴장감
network	네트워크
never	결코
never, absolutely	절대
nevertheless, but	그렇지만
new city	신도시
new generation	신세대
new grain	햇곡식
new item	신상품
newly	새로
newly married	신혼
newlyweds, newly-married couple	신혼부부
new model	신형
new product	신제품
news	뉴스
news	소식
newspaper	신문
newspaper	신문지
newspaper company	신문사
news, regards	안부
new technology	신기술
new year	새해
new years holidays	연말연시
new year's money	세뱃돈
New York	뉴욕
next, after	다음
next day	다음날
next month	다음달
next week	다음주
next year	내년
next year, following year	다음해
nice to meet, happy	반갑다
Nice to meet you.	반갑습니다
Nice to meet you.	처음 뵙겠습니다
nickname	별명
night	밤
nightmare	악몽
nighttime, during night	야간
night view	야경
no	아뇨
no	아니
no	아니다
no	아니오
no	아니요
No. ~	호
noise	소음
noisy	시끄럽다
no matter how	아무리
none, no, not	없다
no news	무소식
noodle	국수
normal	정상
North	북쪽
north and south	남북
nose	코
nosebleed	코피
no smoking	금연
not at all	전혀
not delicious	맛없다
note	노트
notebook, note	공책
note, notebook	수첩
not funny, uninteresting	재미없다
notice	고지서
notice	통지서
not really	별로
not salty	싱겁다
noun	명사
novel	소설
novel	소설책
novelist	소설가
November	십일월
now	이제
now	지금
nowadays, around this time, lately	요즘
now and then	때로
no way	설마
now, current	현재
number	번호
number of people	인원
number of times	횟수
numbers	숫자
number ticket	번호표
nurse	간호사
nursing	간호
nursing home	양로원
nutrients	영양분
nutrients	영양소
nutrition	영양
nutritional supplement	영양제
nutritional value	영양가
obesity	비만
object, thing	사물
obligation	의무
observation	관찰
obstetrics and gynecology	산부인과
occur, come out	나다
occurrence	발생
October	시월
odd number	홀수
of course	당연히
offer	제공
office	사무실
office	사무소
officetel(office + hotel)	오피스텔
of mine, my	내
often	자주
oh well	글쎄
oh, well	어머
oil, gasoline	기름
oil, petroleum	석유
old, ancient	옛
old lady, madame, aunt	아줌마
old lady, madame, aunt	아주머니
old story, old speech, old tale	옛말
olympic	올림픽
olympic	올림픽
omission, deletion	생략
once	한번
Ondol (Korean traditional heating system)	온돌
one day	하루
one night	하룻밤
one, one of the ~	한
one or two	한두
one-piece dress	원피스
one's 60th birthday	회갑
one's junior, one's subordinate	아랫사람
one week	일주일
onion	양파
online	온라인
online chat	채팅
only	뿐
only daughter	외동딸
only son	외아들
only son	외동아들
only, ten thousand	만
on purpose	일부러
on-site	현장
on the other hand	한편
on the way	도중
on the way to work	출근길
on time	제때
on time	제시간
open	열다
opening ceremony	개막식
opening, opening to the public	개방
opera	오페라
operate on for	수술하다
ophthalmology	안과
opinion	의견
opponent	상대
opponent	상대방
opportunity, change	기회
opposite	반대
opposite side	반대쪽
opposite word	반대말
or	또는
or	혹은
orange	오렌지
orange color	주황색
order	질서
order	차례
order	주문하다
order of arrival	선착순
order, turn	순서
ordinary	일반
ordinary people	일반인
oriental painting	동양화
orientation	오리엔테이션
origin, affiliation	출신
originally	원래
original place	제자리
orphanage	고아원
other	기타
other ~, another ~, different ~	다른
other side, opposite side	건너편
otorhinolaryngology, ENT	이비인후과
our country, South Korea	우리나라
outdoors	야외
outlook	전망
out, outside	밖
output	출력
outside, outdoor	바깥
outstandingly, especially	유난히
overeating	과식
overlap	겹치다
overseas	해외
overseas resident	교포
overseas resident	국외
overseas trip	해외여행
overslept, sleeping in late	늦잠
over there	저곳
overwork	과로
overwork	야근
owner	주인
packing	포장
page	페이지
pain	고통
pain	아픔
pain	통증
painful, sick	아프다
painkiller	진통제
pair	짝
pajama	잠옷
palm	손바닥
pants	바지
paper	종이
paper cup	종이컵
parcel	소포
parent-in-law	시부모님
parents	부모
Parent's day	어버이날
park	공원
park	주차하다
parking lot	주차장
part	부분
part	일부
participation	참가
participation	참여
part-time job	아르바이트
party	파티
party, feast	잔치
pass	합격
pass by	지나다
passenger	승객
passenger car	승용차
pass, lead	통하다
passport	여권
past	과거
past, old days	예전
pastor	목사
paternal aunt	고모
paternal uncle	삼촌
paternal uncle	고모부
patient	환자
pattern	무늬
payphone, public phone	공중전화
pay, put out	내다
peace	평화
peach	복숭아
peanuts	땅콩
pedagogy	교육학
peel, skin	껍질
pen	펜
pencil	연필
pencil case	필통
pepper powder	고춧가루
peptic, digestive	소화제
percent	퍼센트
perfectly, just	딱
performance	연주
performance, function	성능
performance hall	공연장
(performance) stage	무대
perfume, nostalgia	향수
perm	파마
permission	허락
persimmon	감
persistence	고집
personality	성격
person in charge	담당자
person, man	사람
~ person(s)	명
~ person(s), ~ minute(s)	분
persuasion	설득
pesticides	농약
pet dog	애완견
pets	애완동물
pharmacist	약사
pharmacy	약국
philosophy	철학
phone bell	전화벨
phone call	통화
phone number	전화번호
photo album	사진첩
photo studio	사진관
physical education	체육
pianist	피아니스트
piano	피아노
pickpocketing	소매치기
pick up	마중
pickup, collection	수거
picnic	나들이
picnic	야유회
picnic, trip	소풍
picture book	그림책
picture frame	액자
picture, photo	사진
pierce, take (a photo), press	찍다
pig	돼지
piggybank	저금통
pig's feet	족발
pile	산더미
pillar	기둥
pillow	베개
pink color	분홍색
pizza	피자
place	곳
place	장소
place	군데
plan	계획
planning	계획성
plans	예정
plant	식물
plastic	플라스틱
plastic surgery	성형
play	놀다
player	선수
play, game	놀이
playground	놀이터
playground, athletic field	운동장
please	제발
plug	플러그
pocket money, allowance	용돈
pocket, pouch	주머니
poet	시인
poetry collection, marriage (for women)	시집
point	점
point	포인트
point, branch	지점
poison	독
police	경찰
police office	경찰서
police officer	경찰관
political science	정치학
politician	정치가
politician	정치인
politics	정치
pollution	공해
pollution	오염
pool, grass	풀
popularity	인기
popular star	인기스타
population	인구
pork	돼지고기
possibility	가능성
possibility, potentiality	가능
post	우편
postcard	엽서
postgraduate student, graduate student	대학원생
post mail	우편물
post office	우체국
post, sentence, character	글
pot	냄비
potato	감자
pour	붓다
poverty	가난
powder soap	가루비누
power	힘
power outage	정전
power supply	전원
practice	연습
practice	연습하다
prayer	기도
pregnancy	임신
pregnant woman	임산부
preparation	준비
prepare	준비하다
prepare, arrange	차리다
prescription	처방
prescription	처방전
presentation	발표회
present-day	현대
presenter	발표자
president	회장
president (of a country)	대통령
press down, push	누르다
pretty, beautiful	예쁘다
prevention	예방
pre-view, preparation	예습
price	값
price	가격
price	물가
prime minister	수상
princess	공주
principle	원리
print	프린트
printed papers	인쇄물
printer	프린터
printing	인쇄
privacy	사생활
prize money, reward	상금
prize, reward	상
problem	문제
problem	문제점
process	과정
processing	처리
product	상품
product	제품
product, goods	물품
production	생산
production	제작
professor	교수
profit	이익
program	프로그램
programmer	프로그래머
progress	진행
promotion	승진
promotion materials	홍보물
pronunciation	발음
properly	제대로
properly (without failure), faithfully	꼬박꼬박
protect	지키다
protection	보호
protein	단백질
proverb	속담
psychologist	심리학자
psychology	심리학
puberty	사춘기
public	대중
public bath	목욕탕
public bath	대중목욕탕
public holiday	공휴일
public official	공무원
public place	공공장소
public relations	홍보
public transportation	대중교통
publishing company	출판사
puppy	강아지
purchase	구매
purchase	구입
purchase order	주문서
purpose	목적
put	놓다
put	두다
put in	넣다
put in for, apply for	신청하다
(put into) practice, action	실천
put on, place	올려놓다
put on, plug, (fog) rolls in	끼다
put on, wear	신다
put on, wear	입다
Pyongyang	평양
qualification	자격
quality	질
quality	물질
quality	품질
quality of living	생활수준
quantity	분량
quantity, amount	수량
quarrel	말다툼
queen	왕비
question	질문
question	물음
question	의문
questionnaire	설문지
questionnaire	설문조사
quickly	빨리
quietly	조용히
quite	꽤
quiz	퀴즈
rabbit	토끼
radio	라디오
radish	무
rag	걸레
rain	비
rain and wind, typhoon	비바람
rainbow	무지개
rain precipitation	강수량
rainy road	빗길
rainy season	장마
rainy season	장마철
ramen	라면
range	범위
rather	오히려
rather	차라리
razor, shaving	면도
reaction	반응
read	읽다
read	독서하다
reading	독서
reading	읽기
reading room	독서실
reading room	열람실
real estate	부동산
reality	현실
really	정말로
really, truly	정말
really, truly	진짜
really, very	참
rear, back	뒤
reason	이유
reason, the opposite sex	이성
receipt	영수증
receive	받다
recent	최근
recently, these days	요새
reception	접수
recipe	요리법
recipe	조리법
recommendation	추천
reconciliation, settlement, compromise	화해
record	음반
record	기록
recovery	회복
recruitment	모집
recruitment	채용
recycled goods	재활용품
recycling	재활용
red	빨갛다
red color	빨간색
red pepper	고추
reduction	감소
reference	참고
refrigerator	냉장고
refund	반품
refund	환불
regardless	상관없이
register	등록
registration card	등록증
registration fee, tuition fee	등록금
regret	후회
regular (customer)	단골
reissue	재발급
rejection	거절
relation	관계
relation	상관
relation	관련
relationships	인간관계
relative	친척
relevance	관련성
relief	안심
religion	종교
remainder, surplus	나머지
remarriage	재혼
remember	기억하다
remote controller	리모컨
remove, pull, pull out	빼다
rent	집세
rental	대여
rental charge	대여료
rent house	전셋집
repair	수리
repair (clothes)	수선
repair cost	수리비
repeat	반복
replenishment	보충
reply	답장
reply	답글
report	보고
report	신고
reporter	기자
reporting/briefing session	보고회
representative	대표
Republic of Korea, South Korea	대한민국
request	요구
request	요청
request, please	부탁
rescue team	구조대
research	연구
research institute	연구소
research laboratory	연구실
resemble	닮다
reservation	예약
reservation, booking	예매
residence	주거
resident	주민
residential area	주택가
resignation	사표
resort	휴양지
resource	자원
respect	존경
respondents	응답자
response, answer	응답
responsibility	책임
rest	쉬다
rest	휴식
restaurant	음식점
restaurant, cafeteria	식당
restroom, toilet, lavatory	화장실
result	결과
retirement	퇴직
return	반납
return, come back	다녀오다
return date	반납일
return, go back	돌아가다
return (to home country)	귀국
review	복습
revision, crystal	수정
rhythm	리듬
rice	쌀
rice bowl	밥그릇
rice cake	떡
rice cake soup	떡국
rice, meal	밥
rice plant	벼
rich family	부잣집
rich person	부자
ride, get on	타다
riding, boarding	승차
right, fit, correct	맞다
right hand	오른손
right, paint, wear	바르다
right side, right	오른쪽
ring	반지
rise, increase	상승
rise, open (the eyes)	뜨다
rise, stand, occur	일어나다
river	강
riverside	강변
river water	강물
road	도로
roadside	길가
robot	로봇
rock, stone	바위
rod, stick	막대기
role	역할
romance, courtship	연애
roof	지붕
room	방
roommate	룸메이트
room to oneself, solitary confinement	독방
room with Ondol	온돌방
root	뿌리
rose	장미
rose of sharon	무궁화
round trip	왕복
route, line	노선
rubber band	고무줄
rubber shoes	고무신
rule	규칙
rumors, reputation	소문
run	뛰다
run	달리다
running	달리기
rural	농촌
Russia	러시아
sad	슬프다
safe	안전하다
safely	무사히
safety line	안전선
sale	판매
sale, discount	할인
sales	영업
sales department	영업부
saliva	침
salt	소금
salty, make (the plan)	짜다
same	같다
same	똑같다
Samgyetang	삼계탕
sand	모래
sandwich	샌드위치
satisfaction	만족
satisfaction (feeling)	만족감
Saturday	토요일
sauce	소스
sauna	찜질
sauna	사우나
save, seek, get	구하다
saving, frugality	절약
savings	저금
savings	저축
say, talk	말하다
scale (weight)	저울
scanner	스캐너
scary	무섭다
scent	향
schedule	일정
schedule, timetable	시간표
scholar	학자
scholarship	장학
scholarship	장학금
school	학교
school excursion	수학여행
science	과학
scientists	과학자
scissors	가위
score, point	점수
screen	화면
sea	바다
sea bathing	해수욕
seafood	해물
seafood	수산물
seafood	해산물
seal, stamp	도장
search	검색
search word	검색어
season	계절
seasonal change	환절기
seasoning	조미료
seat	좌석
seat, location	자리
seawater	바닷물
seaweed	김
seaweed	미역
seaweed soup	미역국
second half	후반전
second hand	중고
second-hand car	중고차
second-hand goods	중고품
~second(s)	초
second, the second of~	둘째
secret	비밀
secretly	몰래
section	마디
~ section(s), temple	절
security	경비
security deposit system of housing	전세
security guard	경비원
see	보다
seed, Mr. ~	씨
self-esteem, pride	자존심
sell	팔다
sell, be sold	팔리다
seller	판매자
semester	학기
seminar	세미나
send, fry, transmit	부치다
send, spend	보내다
seniority, elder	연상
sensation	감동
sense	감각
sentence	문장
Seolleongtang	설렁탕
Seoul	서울
Seoul station	서울역
separately	따로
separately	따로따로
separately, each	각각
separation	분리
September	구월
serial drama, soap opera	연속극
service	서비스
serving	서빙
sesame leaf	깻잎
sesame oil	참기름
sesame salt	깨소금
set up, formulate	세우다
several, various	여러가지
severe, terrible	심하다
shade	그늘
shame, embarrassment	창피
shampoo	샴푸
shape, form, style	모양
share, divide	나누다
shellfish	조개
shiny, sparkly	반짝반짝
shipbuilding, Korea	조선
ship, stomach, pear	배
shirt	셔츠
shirt	와이셔츠
shock, impact	충격
shoes	구두
shoes, footwear	신발
shop	매점
shopping	쇼핑
shopping bag	쇼핑백
shopping basket	장바구니
shopping center	쇼핑센터
shopping mall	쇼핑몰
shopping street, shopping district	상가
short	짧다
shorts	반바지
short term	단기간
shoulder	어깨
shoulder, carry	메다
show	쇼
show, look	보이다
show, public performance	공연
shrimp	새우
shrink, decrease	줄다
shut, close	닫히다
shuttle bus	셔틀버스
sibling	형제
sickness, disease that comes from fatigue	몸살
~side	측
side	옆
side dish	반찬
side effects	부작용
side, episode	편
sideline	부업
side, noodles	면
side, outside	겉
side, page	쪽
sidewalk, report	보도
sigh	한숨
sight	시력
sign	사인하다
signal	신호
signature	서명
signboard	간판
significance, meaning, sense	의의
sign, mark	표시
sign, ~ person(s)	인
silent, quiet	조용하다
silk	실크
silver	은
similar, like	비슷하다
similarly, in the same manner	똑같이
simple, easy	간단하다
simply	간단히
simply	단순히
simultaneous	동시
sincerity	진심
sincerity, devotion	정성
sing	노래하다
singer	가수
sink	싱크대
Sir	님
Sireum, Korean Sumo	씨름
sister (as seen from the younger brother)	누나
sister (as seen from the younger sister)	언니
sisters	자매
sit	앉다
situation, circumstances	형편
situation, status	상황
size	크기
size	사이즈
size, measurement	치수
size, volume	부피
skate	스케이트
skill, technique	기술
skill, tricks	솜씨
skin	피부
skin disease	피부병
skin lotion	로션
skinny	날씬하다
ski resort	스키장
skirt	치마
ski, skiing	스키
sky	하늘
sky blue, light blue	하늘색
sleep	자다
sleep	수면
sleep, go to bed	잠자다
sleepiness	졸음
sleeping, going to bed	취침
sleeping pills	수면제
sleep, rest	주무시다
sleeve	소매
slightly, a little	약간
slightly, quietly	살짝
slipper	슬리퍼
slow	느리다
slowly	천천히
slumbers, sleep	잠
small	작다
small and medium-sized enterprises	중소기업
small, cow	소
small money, small change	잔돈
small scale	소규모
small theater	소극장
smell	냄새
smile	미소
smoke, bloom	피우다
smoking	흡연
SMS, short messages, letters	문자
snack	간식
snack	과자
snack (served with alcoholic beverages)	안주
snake	뱀
snot, nasal discharge	콧물
snowman	눈사람
snowstorm	눈보라
soap	비누
so, as such, like that	그러하다
so, because	그러니까
social life	사회생활
society	사회
socks	양말
sofa	소파
soft, friendly	부드럽다
soil	흙
soju, a Korean liquor	소주
solar heat	태양열
soldier, military personnel	군인
sold out	매진
solid ingredients of a soup	건더기
solution	해결
solution	해소
solution	해결책
solution	해소법
solve	풀다
someday	언젠가
some, few	몇몇
somehow	어쩐지
something else, something that has changed	별일
sometimes	가끔
sometimes	때때로
son	아들
song	가요
song	노래
soon	곧
soon	이내
soon, a little while ago	금방
sooner or later	조만간
soot	매연
sophistication	세련
sorrow, mourn	슬퍼하다
sorrow, sadness	슬픔
sorry	미안하다
sorry	죄송하다
so that	그래야
so, thus	그래서
sound, voice	소리
soup	국
soup	스프
soup bowl	국물
soup bowl	국그릇
soup, juice	탕
sour	시다
south	남쪽
South America	남미
southern	남부
south, man	남
souvenir	기념품
so, very, that	그리
soybean paste soup	된장국
soybean paste stew	된장찌개
soy sauce	간장
space	공간
space	우주
space travel	우주여행
Spanish	스페인어
spare, margin	여유
speaker	스피커
speaking	말하기
specialty	특기
specialty, regional product	특산물
specialty shop	전문점
speed	속도
speed	속력
speed violation	과속
speed violation	속도위반
spicy	맵다
spicy fish soup	매운탕
spider	거미
spirit, zero	영
spoil, deteriorate	나빠지다
spoon	숟가락
sport	스포츠
sports club, gym	헬스클럽
sports shoes	운동화
sportswear, gym clothes	운동복
spouse	배우자
spread, stretch	펴다
spring	봄
square, plaza	광장
squid	오징어
squirrel	다람쥐
stack up, pile up	쌓이다
stadium, arena	경기장
stage, step	단계
stain	얼룩
stairs	계단
stamp	우표
stand	서다
standard, criteria	기준
star	별
star	스타
staring contest, snowball fight	눈싸움
start	시작
start, begin	시작하다
start, departure	출발
startled, surprised	깜짝
start of course (lecture)	개강
statement, signature	성명
station	역
station, bus stop	정류장
station, depot	정거장
stationery	문구
stationery store	문구점
statistics	통계
status	상태
status	지위
stay, spend, live	지내다
steadily	꾸준히
stepmother	새어머니
steps	걸음
stew, soup	찌개
stickers	스티커
stick, pass a test	붙다
stockings	스타킹
stomach ache	복통
stomachache	배탈
stone pot	돌솥
stone, rock	돌
stop	정지
stop, end, cease	그치다
stop, finish	그만
stopping	정차
storage	보관
storage, preservation	저장
storage room	보관실
store	상점
store, shop	가게
story	이야기
story, plot	줄거리
stove, fireplace	난로
straighten out, organize	정리하다
straight hair	생머리
straight line	직선
strange, funny, weird	이상하다
strawberry	딸기
stream, lake	냇가
street	거리
street	길거리
stress	스트레스
string	끈
striped pattern	줄무늬
structure	구조
student	학생
student, disciple, follower	제자
student ID card	학생증
studio	촬영장
studio apartment	원룸
study	공부
study	공부하다
study abroad	유학
studying for an exam	시험공부
stuff, thing	물건
style	스타일
subject, theme	주제
submission	제출
substitute	대리
substitute, change	교체
subtitles	자막
suburbs	시외
suburbs	교외
subway	지하철
subway station	지하철역
subway train	전동차
subway, train	전철
success	성공
successful candidate, winner	합격자
such, of this kind, of this sort	이러하다
suck, do laundry	빨다
suddenly	급히
suddenly	갑자기
(sudden) shower/rain	소나기
sugar	설탕
suggestion	제안
suicide	자살
suit	양복
summary	요약
summer	여름
summer day	여름날
summer vacation	피서
summit, top	꼭대기
sun	태양
Sunday	일요일
Sundubu soup	순두부찌개
sunglasses	선글라스
sunlight	햇볕
sunrise	일출
sunrise	해돋이
sunshine, sunlight	햇빛
superior, senior	웃어른
superior, senior	윗사람
supermarket	마트
supermarket	슈퍼마켓
supplement, acupuncture medicine	보약
support	지원
supporter	지원자
sure, of course	물론
surgery department	외과
suspension	중단
swallow	제비
swarm, unreasonable	무리
sweat	땀
sweater	스웨터
sweep, clean	청소하다
sweet	달다
sweet potato	고구마
swimming	수영
swimming pool	수영장
swimsuit	수영복
swing	그네
symbol	기호
symbol	상징
symptom, medical condition	증세
symptoms	증상
system	제도
system	시스템
table	식탁
table	테이블
table for having a meal	밥상
table tennis	탁구
table, ticket	표
tablet medicine	알약
Taekwondo	태권도
tail	꼬리
take a bath	목욕하다
take a look	구경하다
take a picture	촬영하다
take a shower	샤워하다
take away	가져가다
take off (clothes, shoes)	벗다
take out	꺼내다
take you, serve you (honorific form)	모시다
talent, skills	재주
talk	말씀하다
talk	얘기하다
talk	이야기하다
tape	테이프
tap water	수돗물
tardy, being late	지각
target, goal	목표
task	과제
tax	세금
taxi	택시
teach	가르치다
teacher	강사
teacher	교사
teacher	선생님
teaching materials	교재
team	팀
team leader	팀장
tear	눈물
technician	기술자
teenager	청소년
telephone	전화
telephone	전화기
tell	전하다
temperature	기온
temperature	온도
temple, employee	사원
temporarily, for a while	한동안
temporary	일시
temporary	임시
tennis	테니스
tent	텐트
terminal	터미널
term, period	기간
textbook	교과서
Thailand	태국
thank	감사
thank	고맙다
thank, appreciate	감사하다
thankfulness	고마움
thanks for, thanks to	덕분
thanks (to someone)	덕
thank you	감사합니다
thank you	감사드립니다
Thank you	고맙습니다
Thank you (past tense)	고마웠습니다
that	저
that	저거
that	저것
that day	그날
that is, which means	즉
that much	그만큼
that person	걔
that person	쟤
that person	저분
That's right.	맞아요
That's right.	맞습니다
That's right.	그렇습니다
that, thing, it	것
(the amount of) rainfall	강우량
theater	연극
theater, cinema	극장
the back view	뒷모습
(the country's) literature	국문학
the day after tomorrow	모레
the day before	전날
the day of the year to eat nourishing food	복날
the dead, casualty, victim	사망자
the feeling of reward	보람
the fifteenth day of the calendar	보름
the first	최초
theft	도난
the last place	꼴찌
them, they	그들
then	그럼
then	그리하여
then, at that time	그때
then, if so	그러면
then, such	그런
the original literature	본문
theory	설
the other person	상대편
the person concerned	관계자
there	거기
there	그곳
therefore	그러니
therefore, hence	따라서
there, over there	저기
there, over there	저쪽
there, the person	그쪽
The United Kingdom	영국
The United States	미국
the way one speaks	말투
the youngest	막내
thick	두껍다
thief	도둑
thin	얇다
think	생각하다
thinking, thought	생각
third	셋째
this	이거
this	이것
this and that, various	이런저런
this and that, various, everything	이것저것
this much	이만큼
this much of, at here	이만
this person	얘
this person	이분
this place, here	이곳
this, such ~	이런
this time	이번
this, tooth, 2	이
this way	이리
this way, here, this person	이쪽
this year	올해
thoroughly, meticulously	꼼꼼히
thoughtlessly, mindlessly	함부로
thoughts, feelings	소감
three or four	서너
thunder	벼락
Thursday	목요일
ticket	티켓
ticket office	매표소
tie	매다
tiger	호랑이
time	때
time	시간
~ time(s)	번
~ times	～회
tired	피곤하다
title	제목
to accept	받아들이다
to accomplish, to achieve	해내다
to accomplish, to achieve, to compose	이루다
to add	합하다
to add on, to get worse	더하다
to admit, to accept	알아주다
to approach, to come closer	다가오다
to argue, to fight	다투다
to ask politely	여쭈다
to assemble	맞추다
to avoid	피하다
tobacco	담배
tobacco fire	담뱃불
to be absurd, to be nonsensical, to be ridiculous	황당하다
to be accurate	정확하다
to be achieved, to be composed of	이루어지다
to be active	활발하다
to be amazing, to be remarkable	놀랍다
to be annoying	골치가 아프다
to be annoying, to be regretful, to be sad	속상하다
to be appropriate	적당하다
to be ashamed of	부끄러워하다
to be awkward	어색하다
to be based on	의하다
to be blue	푸르다
to be bored	심심하다
to be boring	지루하다
to be bothersome, to be tedious	귀찮다
to be broken, to be ruined	망가지다
to be calm, to be gentle	얌전하다
to be calm, to be quiet	차분하다
to be chased	쫓기다
to be cheap	저렴하다
to be cheerful, to be bright	명랑하다
to be chilly	쌀쌀하다
to be clear	뚜렷하다
to be clever, to be smart	똑똑하다
to be clumsy, to be unskilled	서투르다
to become famous	이름나다
to become hot	뜨거워지다
to be comfortable	편안하다
to be common	흔하다
to be compassionate, to be kind	다정하다
to be connected	이어지다
to be cool, to be chilly	선선하다
to be correct	옳다
to be cozy	포근하다
to be crowded	붐비다
to be curious	궁금하다
to be cut	끊어지다
to be deep	깊다
to be depressed	우울하다
to be detailed, to be minute	자세하다
to be distinct, to be clear	분명하다
to be distressed	괴로워하다
to be done	당하다
to be dull	둔하다
to be durable, to be strong	튼튼하다
to be easy	손쉽다
to be eccentric, to be unique, to be new	색다르다
to be embarrassed, to be bewildered	당황하다
to be enough, to be rich	넉넉하다
to be envious of	부럽다
to be excited, to have fun	신나다
to be extremely big	커다랗다
to be extreme, to be severe	지나치다
to be fancy	화려하다
to be fantastic, to be amazing	멋지다
to be fast, to be quick	얼른
to be fat	뚱뚱하다
to be fine, to be clear, to be bright	화창하다
to be fluent	유창하다
to be fresh	생생하다
to be fresh	신선하다
to be fresh, to be lively	싱싱하다
to be fun, to be cheerful	유쾌하다
to be generous	너그럽다
to be given	주어지다
to be graceful	우아하다
to be greasy	느끼하다
to be great	대단하다
to be great	위대하다
to be great, to be excellent	훌륭하다
to be great, to be wonderful	굉장하다
to be hard, to be stiff	딱딱하다
to be harmful	해롭다
to be heard	들리다
to be honest	솔직하다
to be honest	정직하다
to be hot and humid	무덥다
to be important	소중하다
to be impossible	불가능하다
to be in a good relationship	사이좋다
to be incessant, to be unceasing	끊임없다
to be in charge, to be responsible	책임지다
to be inferior, to be behind	뒤떨어지다
to be insufficient	모자라다
to be itchy	가렵다
to be lazy	게으르다
to be lazy, to be laid back	느긋하다
to be leisurely, to be relaxed	한가하다
to believe in	믿다
to be lonely	쓸쓸하다
to be melt	녹다
to be messy, to be dirty	지저분하다
to be meticulous	꼼꼼하다
to be mysterious, to be amazing, to be marvelous	신기하다
to be natural,to be justifiable,to be fair	당연하다
to be neat, to be organized	단정하다
to be needless, to be useless	쓸데없다
to be new	새롭다
to be noble, to be rare, to be fine	귀하다
to be nostalgic, to be missed	그립다
to be not distant	머지않다
to be not in one's right mind	정신없다
to be nutty	고소하다
to be obvious, to be clear	뻔하다
to be old	낡다
to be old	오래되다
to be ordinary, to be usual, to be common	평범하다
to be painful	괴롭다
to be pathetic	불쌍하다
to be placed	놓이다
to be pleased, to be glad	반가워하다
to be polite	공손하다
to be possible	가능하다
to be proper, to be honest	올바르다
to be pure, to be innocent	담백하다
to be put in (a container)	담기다
to be rare	드물다
to be read	읽히다
to be reassuring, to be reliable	든든하다
to be recognized, to be accepted	인정받다
to be red	붉다
to be regrettable, to be precious	아깝다
to be reliable	믿음직스럽다
to be reliable, to be strong	씩씩하다
to be rich, to be abundant	풍부하다
to be rough	험하다
to be round	둥글다
to be saved	살아나다
to be scared	무서워하다
to be scolded	야단맞다
to be serious	심각하다
to be shattered	부서지다
to be shy	쑥스럽다
to be shy, to be ashamed	부끄럽다
to be simple	단순하다
to be sleepy	졸리다
to be slim and long	갸름하다
to be slippery	미끄럽다
to be soft, to supple	연하다
to be solid, to be hard, to be strong	단단하다
to be sorry, to be regrettable	섭섭하다
to be sorry, to be remorseful	서운하다
to be special	특별하다
to be squared	네모나다
to be strange, to be bizarre	엉뚱하다
to be strict	엄격하다
to be strong	강하다
to be stuffy, to be suffocating	답답하다
to be stung, to get bitten	물리다
to be such a one's thoughts	어떠하다
to be such a one's thoughts	어떡하다
to be suitable	적절하다
to be superior	뛰어나다
to be sure	확실하다
to be sure enough	틀림없다
to be sweet	달콤하다
to be sweet and spicy	매콤하다
to be taken away	빼앗기다
to be thick	굵다
to be thick, to be dark	짙다
to be thick, to be dark	진하다
to be thin	가늘다
to be thirsty	목마르다
to be timid, to be cowardly	소심하다
to be tired, to be exhausted	지치다
to be torn, to be ripped	찢어지다
to be tremendous, to be enormous	엄청나다
to be tricked	속다
to be trustworthy	믿음직하다
to be twined	감기다
to be ugly	못생기다
to be unaware of, to not realize	몰라보다
to be unfamiliar	낯설다
to be uniform, to be constant	일정하다
to be unique	독특하다
to be unkind	불친절
to be unrelated	관계없다
to be unsatisfied, to be sorry	아쉽다
to be untied, to be relieved	풀리다
to be vacant, to be empty	비다
to be valuable	귀중하다
to be varied	다양하다
to be very dark, to be pitch-dark	캄캄하다
to be weak	약하다
to be well-mannered, to be gentle	점잖다
to be white	희다
to bite	물다
to block	막다
to blow away	날리다
to boil	삶다
to boil quickly	데치다
to boil, to learn	익히다
to break	깨뜨리다
to break, to ruin	망가뜨리다
to break, to tear	찢다
to break up, to leave	헤어지다
to bring	데려오다
to bundle, to tie	묶다
to burn	불태우다
to burn, to bake	태우다
to burst, to happen suddenly	터지다
to capture	사로잡다
to catch	붙잡다
to change	갈다
to change	변하다
to change	달라지다
to change clothes	갈아입다
to chase	쫓다
to chase around	쫓아다니다
to clean up, to remove	치우다
to clear up	개다
to collapse, to be pulled down	무너지다
to collide	부딪치다
to come alive	살아오다
to come and go	오가다
to come face to face	마주보다
to compare	비하다
to connect, to tie, to continue	잇다
to count	세다
to cover	씌우다
to crawl	기다
to cultivate	가꾸다
to cut	끊다
to cut back	덜다
to date	사귀다
to dawn	새다
today	오늘
today	오늘날
to deal with	다루다
to deceive	속이다
to decorate	꾸미다
to decrease	줄어들다
to delay	늦추다
to detach, to take away	떼다
to dig down, to carve	파다
to disappear	사라지다
to display, to reveal	나타내다
to distinguish	가리다
to doze	졸다
to dream	꿈꾸다
to dress someone up	입히다
to drop	빠뜨리다
to drop	떨어뜨리다
to dry, to expose to the air	널다
to eat (honorific)	잡수다
to emerge, to occur	생겨나다
to encounter, to come into contact	접하다
to endure	참다
to endure	견디다
to entrust	맡기다
to erase	지우다
toe(s)	발가락
to escape	달아나다
to escape, to run away	도망가다
to exaggerate	과장하다
to exchange	주고받다
to experience, to go through	겪다
to explore, to observe	살피다
to explore, to observe	살펴보다
to extend	뻗다
to fail, to not go well	안되다
to fall asleep	잠들다
to fall in love	반하다
to fall in love, to sink down	빠지다
to fall, to collapse	쓰러지다
to fear	두려워하다
to feed	먹이다
to feel a chill, to be painfully cold	시리다
to feel cool and fresh	상쾌하다
to feel jealous	부러워하다
to feel sorry	안타깝다
to find out	찾아내다
to flip	뒤집다
to float	떠오르다
to flow, to run	흐르다
to fly	날다
to fly around	날아다니다
to fly away	날아가다
to fly in	날아오다
to fly up, to soar	날아오르다
to fold, to quit	접다
to follow (after someone)	따라다니다
to freeze	얼다
to fry, to bounce	튀기다
tofu	두부
tofu soup	두부찌개
to gather	몰려들다
to get angry	혼나다
to get bigger, to grow	커지다
to get broken	부러지다
to get burned	데다
to get caught	잡히다
to get caught	붙잡히다
to get collided	부딪히다
to get crowded	몰리다
to get dirty	더러워지다
to get drunk	취하다
to get fat	찌다
to get fat	살찌다
together	같이
together	함께
to get less	적어지다
to get locked, to submerged	잠기다
to get low, to bend low	숙이다
to get married (for women)	시집가다
to get married (of men)	장가가다
to get old	늙다
to get out	벗어나다
to get red	빨개지다
to get returned	돌려받다
to get rid of, to dispose of	없애다
to get rotten, to get damaged	상하다
to get sick of, to get tired of	싫증
to get smaller	작아지다
to get tired, to get bored	지겹다
to get treated	얻어먹다
to get wet, to get soaked	젖다
to give birth	낳다
to give up	포기
to go forward, to get involved	나서다
to go mad, to be crazy	미치다
to go out, to be extinguished	꺼지다
to go through	거치다
to go up and down	오르내리다
to grab	집다
to grow up	자라다
to hand over	넘기다
to hand over, to start (a conversation)	건네다
to harass, to bully	괴롭히다
to hate, to be annoying	밉다
to have a high standard	까다롭다
to have bad manners	버릇없다
to have no relation	상관없다
to have something ahead	앞두다
to head	향하다
to heal	낫다
to hesitate	망설이다
to hide	숨다
to hide (something)	숨기다
to hurry, to rush	서두르다
toilet bowl	변기
toilet paper	휴지
toilet paper	화장지
toiletries, washing accessories	세면도구
to illuminate	비추다
to improve	나아지다
to increase	높이다
to increase (the number or volume)	늘리다
to increase, to become bigger	불어나다
to indicate	가리키다
to interrupt	끼어들다
to jump around, to run around	뛰어다니다
to jump off	뛰어내리다
to jump over	뛰어넘다
to keep someone alive, to bring someone to life	살리다
to kick out	내쫓다
to kick out	쫓아내다
to kill	죽이다
Tokyo	도쿄
to lay	깔다
to let/make someone sit down	앉히다
to light up	켜지다
to line up	늘어서다
to listen (to someone)	들어주다
to live	살아가다
to lock (a door)	잠그다
to look around	둘러보다
to look at	바라보다
to look back	돌아보다
to look back, to think back	되돌아보다
to look down	내려다보다
to look for	찾아보다
to make a hole	뚫다
to make fun of	놀리다
to make someone wear (shoe)	신기다
to make something empty	비우다
to make up one's mind	마음먹다
tomato	토마토
tomb	무덤
to meet (coincidentally)	마주치다
to memorize	외우다
to miss, to be nostalgic	그리워하다
to miss, to lose	놓치다
to mix, to rub	섞다
to mix, to rub	비비다
tomorrow	내일
to move on	나아가다
to move on to	넘어가다
to narrow, to make something smaller	좁히다
to nurture, to make it bigger	키우다
to obtain	얻다
too, excessively	하도
tool	도구
to open, to spread	벌리다
toothbrush	칫솔
toothpaste	치약
to overflow	넘치다
too, very	너무
too~, very	너무나
to pack, to prepare	챙기다
to pass by	지나가다
to pass on, to leave	물려주다
to peel	까다
to perish, to breakdown	망하다
to pick up	줍다
to plant	심다
to pluck, to pick, to get	따다
Toppogi	떡볶이
to prepare	갖추다
to prey on, to feed on	잡아먹다
to procrastinate, to extend	미루다
to provide, to prepare	마련하다
to pull	끌다
to pull	당기다
to pull out, to choose	뽑다
to pull, to guide	이끌다
top, up	위
to push	밀다
to put in (a container)	담다
to put on, to get buried	묻히다
to put on, to pile on	싣다
to question closely	따지다
to quit	그만두다
to raise, to post	올리다
to raise, to sit upright	일으키다
to realize	깨닫다
to recognize	알아보다
to recommend, to offer	권하다
to reduce, to shrink	줄이다
to regain	되돌리다
to remain, to be left	남다
to remember, to recall	기억나다
to remember, to recall	생각나다
to repair (clothes)	수선하다
to result from, to be caused by, to be due to	인하다
to return	돌려주다
to return	돌려보내다
to return, to reward	갚다
to reveal, to disclose	밝히다
to revive	되살아나다
to roll	구르다
to run	뛰어가다
to run out	바닥나다
to run (to come)	달려오다
to run (to come)	뛰어오다
to run (to go)	달려가다
to rush in, to be pushed into	밀려오다
to rush out, to leap out	뛰쳐나가다
to satisfy, to fill in	채우다
to save, to be frugal	아끼다
to scold	꾸짖다
to scold	혼내다
to scold	야단치다
to scratch	긁다
to scream, to shout	외치다
to search around	찾아다니다
to shake	흔들다
to shake off	털다
to shine, to glitter	반짝이다
to shiver, to shake	떨다
to shoot	쏘다
to sink	가라앉다
to slide	미끄러지다
to spend (time, money)	들이다
to spill	쏟다
to spill, to pour, to fall heavily	쏟아지다
to spill, to shed	흘리다
to spin, to get around	돌다
to spit out	뱉다
to spray, to spread	뿌리다
to spread	퍼지다
to spread	펼치다
to stack, to build	쌓다
to stare, to look up	쳐다보다
to stay	머무르다
to stay (at a hotel)	묵다
to stay overnight	새우다
to stay up all night	밤새우다
to steal	훔치다
to step back, to withdraw	물러서다
to step on	밟다
to stop	멈추다
to stop by	들르다
to stop (conflict)	말리다
to stretch, to increase	늘어나다
to sum, to match	합치다
to survive	살아남다
to swallow	삼키다
to swim	헤엄치다
to take away	빼앗다
to take care	돌보다
to take care of	보살피다
to take off (clothes)	벗기다
to take over, to undertake	맡다
total, comprehensive	종합
to taste	맛보다
to tell (someone)	들려주다
to throw	던지다
to tie	맺다
to tighten, to pester	조르다
to tilt	기울이다
to touch	대다
to tremble, to be shaken	떨리다
to try hearing	들어보다
to try, to attempt	해보다
to turn	돌리다
to turn back	돌아서다
touch	만지다
to understand	알아듣다
tourism	관광
tourist	관광객
tourist attraction	관광지
to violate	어기다
to visit	다녀가다
to vomit	토하다
to wake someone up	깨우다
to walk around	돌아다니다
to wander, to get lost	헤매다
to watch, to take care	지켜보다
to wave, to shake	흔들리다
to wear deeply	눌러쓰다
towel	타월
towel, washcloth	수건
to widen	넓히다
to win	이기다
town, neighborhood	동네
toy	장난감
trade	무역
tradition	전통
traditional culture	전통문화
traditional Korean music	국악
traditional Korean palace	고궁
traditional Korean paper	한지
traffic	교통
traffic accident	교통사고
train	기차
train	열차
training	연수
training	훈련
train station	기차역
train ticket	기차표
transaction	거래
transfer	갈아타다
translation	번역
transportation	교통편
transportation	교통수단
trash can	휴지통
trash can	쓰레기통
travel	여행
travel agency, travel firm	여행사
travel destination	여행지
traveler	여행자
travel expenses	여행비
travelogue, travel essay	기행문
travel, sightsee	관광하다
treasure	보물
treat	치료하다
treatment medicine	치료제
tree	나무
trend	유행
trimming, repair	손질
triple, 3 times	세배
truck	트럭
trust, faith	믿음
truth	진실
t-shirt	티셔츠
Tuesday	화요일
tuition fee	학비
tuna	참치
turn left	좌회전
turn off, extinguish, stop	끄다
turn on (the light, the power, etc.)	켜다
turn on (the switch)	틀다
turtle	거북이
tutor lesson	과외
TV	텔레비전
twins	쌍둥이
two	두
two days	이틀
two, three	두세
two years ago	재작년
type	타입
typhoon	태풍
ultraviolet rays	자외선
umbrella	우산
unbalanced diet	편식
uncle	큰아버지
uncle	작은아버지
uncle, mister	아저씨
uncomfortable, inconvenient	불편하다
underground	지하
underline	밑줄
underpass	지하도
understand	이해하다
understanding	이해
underwear	내복
underwear	속옷
unemployment crisis	취업난
unexpectedly	뜻밖에
unexpectedly	의외로
unification	통일
uniform	유니폼
unique	고유하다
unit	단위
university, college	대학
university, college	대학교
unmanned, no person	무인
unmarried and old man	노총각
unnecessary	불필요
upper floors	고층
upright, straight	똑바로
usage	이용
usage fee	사용료
usage fee	이용료
use	사용하다
use	이용하다
useless	소용없다
uselessly, unreasonably	쓸데없이
useless talk, idle talk	잔소리
user	이용자
username, ID	아이디
usual day	평소
usually, in general	대체로
usually, normally, in general	보통
utility charges	공공요금
utilization	활용
vacation	방학
vacation, holiday	휴가
vacuum cleaner	청소기
valuably, carefully	소중히
value	가치
various	각종
various kinds of	온갖
various, many	여러
vegetable	야채
vegetable	채소
vegetarian	채식
vegetarian person	채식주의자
vending machine	자판기
ventilation	환기
versus, large	대
very	무척
very, basically	워낙
very, completely	아주
very, terribly	몹시
victim	피해자
victim	희생자
victory	승리
victory, championship	우승
video	영상
video	비디오
video	동영상
video camera	비디오카메라
Vietnam	베트남
viewing	관람
view, landscape	경치
village	마을
vinegar	식초
vinyl	비닐
violation	위반
violin	바이올린
virgin	처녀
virtual	가상
virus	바이러스
visa	비자
visit	방문
visual sense	시각
vitamin	비타민
vocabulary	어휘
voice	음성
voice	목소리
voice recorder	녹음기
voice recording	녹음
volcano	화산
volleyball	배구
volume	볼륨
volunteer	봉사
volunteer person	봉사자
vote	투표
vowel	모음
waist, hip	허리
wait	기다리다
wake up, crack, break	깨다
walk	걷다
walk	산책
walk (come)	걸어오다
walk (go)	걸어가다
walking path	산책로
wall	벽
wallet	지갑
wall, fence, hedge	담
wall-hanging	벽걸이
want	싶다
want, wish, desire	원하다
war	전쟁
warm	따뜻하다
warning	경고
wash	씻다
wash	세수하다
washbasin, sink	세면대
washing dishes, dish-washing	설거지
washing machine	세탁기
waste (of use)	낭비
waste (of use)	과소비
water	물
water drop	물방울
waterfall	폭포
water faucet	수도꼭지
watermelon	수박
wave, green onion	파
way back from home	퇴근길
way, method	방법
way of thinking	사고방식
way of use	소용
way, road	길
we	저희
wealth, property	재산
weather	날씨
weather forecast	일기예보
website	사이트
wedding anniversary	결혼기념일
wedding ceremony	결혼식
wedding dress	웨딩드레스
wedding hall	예식장
wedding hall	결혼식장
Wednesday	수요일
week	주
weekday	평일
weekend	주말
weight	무게
welcome	환영하다
welcome party	환영회
well	잘
well	우물
well, I see.	그렇구나
well-known, familiar	익숙하다
western	서부
western, west	서양
west, western	서쪽
we, us	우리
whale	고래
what	뭐
what	무슨
what	무엇
what	무엇이
wheels	바퀴
when	언제
where	어디
which, how	어느
which, what	어떤
while	간
white	하얗다
white color	흰색
white color	하얀색
who	누가
who	누구
whole-body	온몸
why	왜
wide	넓다
wife	아내
wife, Mrs.	부인
wife (of a boss)	사모님
will	의지
wind	바람
window	창
window	창문
window glass	유리창
wine	와인
wine	포도주
wings	날개
winter	겨울
winter vacation	겨울방학
wipe, polish	닦다
wireless	무선
wise mother and good wife	현모양처
wish	소원
with all one's strength	힘껏
within, not ~	안
with one's whole heart, elaborately	정성껏
without	없이
without fail, certainly	반드시
wits, sense	눈치
woman	여자
women's clothing	숙녀복
women's clothing	여성복
(women's) short hairstyle	단발머리
won (currency units of Korea)	원
word	단어
word by word, letter by letter	또박또박
words, remarks	말씀
word, talk	말
work	근무
work	일하다
work, 1, day	일
worker	직장인
worker, laborer	근로자
work, job	업무
work, job, operation	작업
work, piece	작품
workplace	직장
workplace	일자리
world	세계
world	세상
world cup	월드컵
worries	걱정거리
worry	걱정하다
worry, trouble	고민
wound, scratch	상처
wrapping paper	포장지
wreck, mess, ruin	엉망
wrinkles	주름
writer	작가
write, use, wear (glasses)	쓰다
writing, dictation	쓰기
writing lyrics	작사
(written) contract	계약서
(written) report	보고서
wrong	틀리다
Yangban, nobility	양반
yarn, thread	실
yawn	하품
Yeah (answer)	응
year	년
year	연도
years	세월
year, sun	해
yellow	노랗다
yellow color	노란색
yellow dust, asian dust	황사
yen	엔
yes	예
yes, 4	네
yesterday	어제
yesterday	어저께
Yes, that's it.	그렇다
Yes, Yeah	그래
yet, still	아직
yielding, concession	양보
yoga	요가
yogurt	요구르트
you	너
you	당신
young	젊다
young	어리다
young boy	소년
younger brother	남동생
younger sister	여동생
young people	젊은이
youth	젊음
youth	청년
zipper	지퍼
zodiac	띠
zoo	동물원
