가게	store, shop
가격	price
가구	furniture
가깝다	close
가끔	sometimes
가다	go
가르치다	teach
가방	bag
가볍다	light
가수	singer
가슴	chest, breast
가요	song
가운데	middle
가위	scissors
가을	autumn, fall
가장	most
가져가다	take away
가져오다	bring
가족	family
가지	branch
가지다	have
각	each
간	while
간단하다	simple, easy
간단히	simply
간식	snack
간장	soy sauce
간호사	nurse
갈비	Galvi, spareribs
갈비탕	Galbitang, spareribs soup
갈색	brown
갈아타다	transfer
감	persimmon
감기	cold
감기약	cold medicine
감다	close ~ (eyes)
감동	sensation
감동하다	be impressed
감사	thank
감사드립니다	thank you
감사하다	thank, appreciate
감사합니다	thank you
감자	potato
감자탕	Gamjatang, potato soup
갑자기	suddenly
값	price
강	river
강아지	puppy
강좌	lecture
갖다	have
같다	same
같이	together
개	dog, ~ piece(s)
개나리	forsythia
개인	individual
거기	there
거리	street
거실	living room
거울	mirror
거의	almost, nearly
거짓말	lie
걱정	anxiety, concern
걱정하다	worry
건강	health
건강하다	be healthy
건너가다	cross (a road)
건너다	cross over
건너편	other side, opposite side
건물	building
건배	cheers, toast
걷다	walk
걸다	bet, call
걸리다	get caught, take (time)
걸어가다	walk (go)
걸어오다	walk (come)
검은색	black
것	that, thing, it
게임	game
겨울	winter
겨울방학	winter vacation
결과	result
결정	decision
결정하다	decide
결혼	marriage
결혼식	wedding ceremony
결혼하다	get married
경기	competition, game
경기장	stadium, arena
경복궁	Gyeongbokgung
경주	Gyeongju
경찰	police
경찰관	police officer
경찰서	police office
경치	view, landscape
경험	experience
계단	stairs
계란	egg
계산하다	calculate
계속	continue
계시다	be, exist (honorific form)
계절	season
계획	plan
고기	meat
고등학교	high school
고등학생	high school student
고르다	choose
고마웠습니다	Thank you (past tense)
고맙다	thank
고맙습니다	Thank you
고모	paternal aunt
고모부	paternal uncle
고속버스	express bus
고양이	cat
고장	broken, malfunction
고추	red pepper
고추장	Kochujang, red pepper paste
고치다	fix
고프다	hungry
고향	hometown
곧	soon
골목	alley
골프	golf
곱다	beautiful
곳	place
공	ball
공간	space
공기	air
공무원	public official
공부	study
공부하다	study
공연	show, public performance
공원	park
공중전화	payphone, public phone
공짜	free
공책	notebook, note
공항	airport
공휴일	public holiday
과	division
과거	past
과일	fruit
과자	snack
과학	science
관계	relation
관광하다	travel, sightsee
관심	attention, interest
광고	advertisement
괜찮다	be okay
괜찮습니다	It's fine.
교과서	textbook
교수	professor
교실	classroom
교체	substitute, change
교통	traffic
교통사고	traffic accident
교회	church
구	9
구경하다	take a look
구두	shoes
구름	cloud
구십	90
구월	September
구하다	save, seek, get
국	soup
국내	domestic
국립	nationalestablished, state
국수	noodle
국어	Korean language
국적	nationality, country of citizenship
국제	international
군인	soldier, military personnel
굽다	bake
권	~ book(s)
귀	ear
귀엽다	cute
규칙	rule
귤	mandarin orange
그	it
그거	it
그것	it
그곳	there
그날	that day
그냥	just, as it is
그동안	meantime, meanwhile, up to now
그들	them, they
그때	then, at that time
그래	Yes, Yeah
그래서	so, thus
그램	gram
그러나	but, however
그러니까	so, because
그러면	then, if so
그런	then, such
그런데	by the way, however
그럼	then
그렇게	like that, so
그렇구나	well, I see.
그렇다	Yes, that's it.
그렇습니다	That's right.
그렇지만	nevertheless, but
그릇	bowl, container, tableware
그리고	and
그리다	draw
그림	drawing, picture
그만	stop, finish
그분	his, the person
그저께	day before yesterday
그중	among them
그쪽	there, the person
그치다	stop, end, cease
극장	theater, cinema
근처	nearby, neighborhood
글	post, sentence, character
글쎄요	I do not know., well, I guess ~
금방	soon, a little while ago
금연	no smoking
금요일	Friday
금주	abstinence, temperance
급	class, grade
급하다	hurry, urgent
기간	term, period
기다리다	wait
기르다	cultivate, grow
기름	oil, gasoline
기분	feeling
기뻐하다	glad, delight
기쁘다	happy
기사	article, driver, engineer
기숙사	dormitory
기억하다	remember
기온	temperature
기자	reporter
기차	train
기침	cough
기타	other
긴장되다	be nervous
길	way, road
길다	long
김	seaweed
김밥	Kimbab
김치	Kimchi
김치찌개	Kimchi stew
김포공항	Gimpo International Airport
까만색	black color
까맣다	black
깎다	cut, shave
깜짝	startled, surprised
깨끗하다	clean
깨다	wake up, crack, break
깨지다	chip, crack, break
꺼내다	take out
껌	chewing gum
꼭	exactly, absolutely
꽃	flower
꽃집	florist
꾸다	dream
꿈	dream
끄다	turn off, extinguish, stop
끓이다	boil
끝	end
끝나다	finish, end
끝내다	finish
끼다	put on, plug, (fog) rolls in
나	I
나가다	go out, get out
나누다	share, divide
나다	occur, come out
나라	country
나무	tree
나빠지다	spoil, deteriorate
나쁘다	bad
나오다	come out, appear
나이	age, old
나중	later, after
나타나다	appear
나흘	four days
낚시	fishing
날	day
날씨	weather
날짜	date
남	south, man
남기다	leave
남녀	men and women
남대문시장	Namdaemun market
남동생	younger brother
남미	South America
남북	north and south
남자	man
남쪽	south
남편	husband
남학생	male student
낮	day, noon, during the day
낮다	low
내	of mine, my
내가	I
내과	internal medicine
내년	next year
내다	pay, put out
내려가다	go down
내려오다	come down
내리다	go down
내용	content
내일	tomorrow
냄비	pot
냄새	smell
냉면	cold noodle
냉장고	refrigerator
너	you
너무	too, very
넓다	wide
넘다	exceed, more than
넘어지다	fall down, fall
넣다	put in
네	yes, 4
넥타이	necktie
넷	4
넷째	fourth
년	year
노란색	yellow color
노랗다	yellow
노래	song
노래방	Karaoke shop
노래하다	sing
노력하다	endeavor, strive
노트	note
녹색	green
녹차	green tea
놀다	play
놀라다	be surprised
농구	basketball
높다	high
놓다	put
누가	who
누구	who
누나	sister (as seen from the younger brother)
누르다	press down, push
눈	eye, snow
눈물	tear
눈사람	snowman
눈싸움	staring contest, snowball fight
눕다	lie down, sleep
뉴스	news
뉴욕	New York
느끼다	feel
느낌	feeling
느리다	slow
늘	always
늘다	gain, increase
능력	ability
늦다	late, delay
늦잠	overslept, sleeping in late
님	Sir
다	all, whole
다녀오다	return, come back
다니다	go, commute
다르다	different
다른	other ~, another ~, different ~
다리	bridge, leg, foot
다섯	5
다시	again
다음	next, after
다음달	next month
다음주	next week
다음해	next year, following year
다이어트	diet
다치다	hurt
닦다	wipe, polish
단어	word
단점	disadvantage, shortcoming, drawback
닫다	close
닫히다	shut, close
달	month, moon
달걀	egg
달다	sweet
달러	dollar
달력	calendar
달리다	run
닭	chicken, hen
닭고기	chicken
닮다	resemble
담그다	dip, pickle
담배	tobacco
답장	reply
당근	carrot
당신	you
대	versus, large
대답	answer
대답하다	answer, reply
대부분	mostly, almost
대사관	embassy
대학	university, college
대학교	university, college
대학생	college student
대학원	graduate school
대학원생	postgraduate student, graduate student
대한민국	Republic of Korea, South Korea
대화	conversation, dialogue
대회	competition, tournament
댁	house
더	more
더럽다	dirty
더운물	hot water
덕분	thanks for, thanks to
덥다	hot
덮다	cover
데리다	bring, take along
데이트	date, dating
도로	road
도서관	library
도시	city
도와주다	help
도움	help, assistance
도착	arrival
도착하다	arrive
도쿄	Tokyo
독서	reading
독서실	reading room
독서하다	read
독일	Germany
돈	money
돌아가다	return, go back
돌아오다	come back, come home
돕다	help
동네	town, neighborhood
동대문시장	Dongdaemun market
동물	animal
동생	brother, sister
동아리	club, group
동안	during, between
동양	eastern, orient
동전	coin
동쪽	east
돼지	pig
돼지고기	pork
되다	become
된장	fermented soybean paste
된장국	soybean paste soup
된장찌개	soybean paste stew
두	two
두껍다	thick
두다	put
두부	tofu
두부찌개	tofu soup
둘	2
둘째	second, the second of~
뒤	rear, back
뒤쪽	behind, back, towards the rear
드라마	drama
드리다	give
드시다	eat (honorific form)
듣기	listening, hearing
듣다	listen
들	field, ~s,
들다	hold, enter
들어가다	go in, enter
들어오다	come in, enter
등	etc, back
등산	hiking, mountain-climbing
등산복	mountaineering clothing
등산화	hiking boots, climbing shoes
디브이디	DVD
디자인	design
따뜻하다	warm
따라가다	follow
따라오다	come with, follow
따로	separately
따르다	follow
딸	daughter
딸기	strawberry
땀	sweat
때	time
때문	because, for ~, so~
떠나다	leave
떠들다	chatter, make a noise
떡	rice cake
떡국	rice cake soup
떡볶이	Toppogi
떨어지다	drop
또	in addition, again
또는	or
똑같다	same
똑바로	upright, straight
뛰다	run
뜨겁다	hot
뜨다	rise, open (the eyes)
뜻	meaning
라디오	radio
라면	ramen
러시아	Russia
로션	skin lotion
마늘	garlic
마르다	dry
마리	~ animal(s), ~ head(s)
마시다	drink
마음	mind, feeling
마지막	last
마치다	finish, end
마흔	40
막히다	be blocked, be clogged
만	only, ten thousand
만나다	meet
만두	dumpling
만들다	make, create
만일	if, should
만지다	touch
만화	comic book, cartoon
많다	many
많이	a lot of, many
말	word, talk
말씀	words, remarks
말씀하다	talk
말하기	speaking
말하다	say, talk
맑다	clear, clean
맛	flavor, taste
맛없다	not delicious
맛있다	delicious
맞다	right, fit, correct
맞습니다	That's right.
맞아요	That's right.
맞은편	across, the other side, opposite
매다	tie
매우	extremely, very
매일	everyday
매주	every week
맥주	beer
맵다	spicy
머리	head, hair
먹다	eat
먼저	first, first of all, before
멀다	far, distant, long
멋있다	cool, nice
메뉴	menu
메다	shoulder, carry
메모	memo
메시지	message
멕시코	Mexico
며칠	a few days, what date
면도	razor, shaving
명	~ person(s)
명절	holidays, annual events
몇	a few, a number of
모두	all, everyone
모레	the day after tomorrow
모르겠습니다	I don't know.
모르다	do not know
모시다	take you, serve you (honorific form)
모양	shape, form, style
모으다	collect, gather
모이다	gather, get together
모임	meeting, gathering
모자	hat
목	neck, throat
목걸이	necklace
목소리	voice
목요일	Thursday
목욕	bath, bathing
목욕하다	take a bath
목적	purpose
몸	body
몸살	sickness, disease that comes from fatigue
못하다	~ can not do
몽골	Mongolia
무	radish
무겁다	heavy
무궁화	rose of sharon
무료	free
무릎	knee
무리	swarm, unreasonable
무섭다	scary
무슨	what
무엇	what
무엇이	what
무역	trade
무용	dance
무척	very
문	door, gate
문구점	stationery store
문장	sentence
문제	problem
문화	culture
묻다	ask
물	water
물건	stuff, thing
물론	sure, of course
물어보다	ask
뭐	what
미국	The United States
미래	future
미리	in advance, beforehand
미술	art
미술관	art gallery, art museum
미안하다	sorry
미안합니다	I'm sorry.
미용실	beauty salon
미터	meter
민속촌	folk village
밀가루	flour
밀리다	be shaved, be pushed
밑	bottom, below
바꾸다	change
바뀌다	be changed
바나나	banana
바다	sea
바닷가	beach
바라다	hope
바람	wind
바로	immediately, soon, just
바르다	right, paint, wear
바쁘다	busy
바이올린	violin
바지	pants
박물관	museum
박수	clap, applause
밖	out, outside
반	half, group
반갑다	nice to meet, happy
반갑습니다	Nice to meet you.
반년	half a year
반달	half-moon
반바지	shorts
반지	ring
반찬	side dish
받다	receive
발	foot, leg
발가락	toe(s)
발음	pronunciation
발전	development
발표	announcement, presentation
밝다	bright
밤	night
밥	rice, meal
방	room
방법	way, method
방송	broadcast
방송국	broadcast stations
방학	vacation
배	ship, stomach, pear
배고프다	hungry
배구	volleyball
배달	delivery
배부르다	be full (I am full.)
배우	actor
배우다	learn
배탈	stomachache
백	100
백화점	department store
버리다	abandon, throw away
버스	bus
번	~ time(s)
번호	number
벌다	earn, make money
벌써	already
벗다	take off (clothes, shoes)
벚꽃	cherry blossom
베이징	Beijing
베트남	Vietnam
벽	wall
변호사	lawyer
별	star
별로	not really
병	illness, ~ bottle(s)
병원	hospital
보내다	send, spend
보다	see
보도	sidewalk, report
보이다	show, look
보통	usually, normally, in general
복숭아	peach
복잡하다	complicated, crowded
볶다	fry
볶음밥	fried rice
볼펜	ballpoint pen
봄	spring
봉지	bag
봉투	envelope
뵙다	meet
부동산	real estate
부드럽다	soft, friendly
부르다	call, sing
부모	parents
부부	couple, husband and wife, married couple
부산	Busan
부업	sideline
부엌	kitchen
부인	wife, Mrs.
부장	director
부지런하다	diligent
부치다	send, fry, transmit
부탁	request, please
부탁하다	beg, ask
북쪽	North
분	~ person(s), ~ minute(s)
분위기	atmosphere
불	fire, electrical light
불고기	Bulgogi, grilled meat
불다	blow (wind or whistle, musical instruments, etc.)
불편하다	uncomfortable, inconvenient
붓다	pour
붙다	stick, pass a test
붙이다	attach, stick
브라질	Brazil
블라우스	blouse
비	rain
비누	soap
비디오	video
비밀	secret
비빔밥	Bibimbap, mixed rice
비슷하다	similar, like
비싸다	expensive
비행기	airplane
비행장	airfield, airport
빌딩	building
빌리다	borrow, lend
빠르다	fast
빨간색	red color
빨갛다	red
빨다	suck, do laundry
빨래	laundry, wash
빨리	quickly
빵	bread
빵집	bakery
빼다	remove, pull, pull out
뿐	only
사	4
사거리	intersection, four corners
사계절	four seasons
사고	accident
사과	apple
사다	buy
사람	person, man
사랑	love
사랑하다	love
사례	case, example
사무실	office
사물	object, thing
사십	40
사업가	entrepreneur, businessman
사용하다	use
사원	temple, employee
사월	April
사이	between, while
사이다	cider
사이즈	size
사인하다	sign
사장	CEO, the president
사전	dictionary
사진	picture, photo
사진기	camera
사촌	cousin
사탕	candy
사흘	3 days
산	mountain
산책	walk
살	flesh, ~ year(s) old
살다	live
삼	3
삼거리	intersection, three-way intersection
삼계탕	Samgyetang
삼십	30
삼월	March
삼촌	paternal uncle
상관	relation
상자	box
상처	wound, scratch
상품	product
새	bird, new
새로	newly
새벽	dawn, late at night, early morning
새우	shrimp
색	color
색깔	color
샌드위치	sandwich
생각	thinking, thought
생각되다	be considered, it seems~
생각하다	think
생기다	form, arise
생선	fish
생신	birthday (honorific form)
생일	birthday
생활	life
샤워하다	take a shower
샴푸	shampoo
서다	stand
서로	each other, both
서류	document
서른	30
서비스	service
서양	western, west
서울	Seoul
서울역	Seoul station
서점	bookstore
서쪽	west, western
선물	gift, present
선배	elder, senior
선생님	teacher
선수	player
선택하다	choose, select
선풍기	fan
설거지	washing dishes, dish-washing
설날	Lunar New Year
설렁탕	Seolleongtang
설명	explanation, description
설명하다	explain
설악산	Mt. Seorak
설탕	sugar
섬	island
성	castle, last name
성격	personality
성함	name
세계	world
세수하다	wash
세우다	set up, formulate
세일하다	have a sale
세탁기	washing machine
세탁소	dry cleaners, laundromat
센터	center
센티미터	centimeter
셋	3
셋째	third
소	small, cow
소개	introduction
소개하다	introduce
소고기	beef
소금	salt
소리	sound, voice
소설	novel
소설가	novelist
소식	news
소파	sofa
소포	parcel
소풍	picnic, trip
소화제	peptic, digestive
속	inside
손	hand
손가락	finger
손님	customer
손수건	handkerchief
송이	bunch, flower, cluster
쇼핑	shopping
수건	towel, washcloth
수도	capital, water supply
수돗물	tap water
수박	watermelon
수술하다	operate on for
수업	class, lesson
수영	swimming
수영복	swimsuit
수영장	swimming pool
수요일	Wednesday
수저	chopsticks and a spoon
수첩	note, notebook
수학	mathematics
숙제	homework
순서	order, turn
숟가락	spoon
술	alcohol, liquor
쉬다	rest
쉰	50
쉽다	easy
슈퍼마켓	supermarket
스물	20
스웨터	sweater
스케이트	skate
스키	ski, skiing
스키장	ski resort
스타	star
스타킹	stockings
스트레스	stress
스페인어	Spanish
스포츠	sport
슬퍼하다	sorrow, mourn
슬프다	sad
습관	habit
시	city, time
시간	time
시간표	schedule, timetable
시계	clock
시골	countryside
시끄럽다	noisy
시내	downtown, city, stream
시다	sour
시디	CD
시민	citizen
시설	facility
시외	suburbs
시원하다	cool, refresh
시월	October
시작	start
시작되다	begin
시작하다	start, begin
시장	market
시청	city hall
시키다	make someone do, order
시험	exam, test
식당	restaurant, cafeteria
식사	meal
식탁	table
신	god, new
신다	put on, wear
신문	newspaper
신발	shoes, footwear
신청서	application forms
신청하다	put in for, apply for
실례	excuse
실례하다	be excused
실수	mistake, failure
싫다	hate
싫어하다	dislike, hate
심하다	severe, terrible
십	10
십이월	December
십일월	November
싱겁다	not salty
싶다	want
싸다	cheap, wrap
싸우다	fight
쌀	rice
쌀밥	cooked rice
쌓이다	stack up, pile up
썰다	chop, cut
쓰기	writing, dictation
쓰다	write, use, wear (glasses)
쓰레기	garbage
쓰이다	be written, be used
씨	seed, Mr. ~
씩	each, every, per
씹다	chew, bite
씻다	wash
아가씨	Miss, daughter
아기	baby, toddler
아까	earlier, while ago
아내	wife
아뇨	no
아니다	no
아니오	no
아니요	no
아들	son
아랍어	Arabic
아래	bottom, under
아름답다	beautiful
아마	maybe, perhaps
아무	any
아버님	father
아버지	father
아빠	dad
아시아	Asia
아이	child
아이스크림	ice cream
아저씨	uncle, mister
아주	very, completely
아주머니	old lady, madame, aunt
아줌마	old lady, madame, aunt
아직	yet, still
아침	morning, breakfast
아침밥	breakfast
아침식사	breakfast
아파트	apartment, mansion
아프다	painful, sick
아프리카	Africa
아홉	9
아흔	90
악기	musical instrument
안	within, not ~
안경	glasses
안내하다	guide, invite
안녕하세요	hi, hello
안녕하십니까	hello
안다	embrace, cradle
안전하다	safe
앉다	sit
알다	know
알리다	inform
알맞다	fit, appropriate
알았습니다	I understood.
앞	front, previous
애	child
액세서리	accessory
야구	baseball
야채	vegetable
약	about, medicine
약간	slightly, a little
약국	pharmacy
약사	pharmacist
약속	appointment, promise
얇다	thin
양	amount, sheep
양말	socks
양복	suit
양식	form, western style
양파	onion
얘기하다	talk
어깨	shoulder
어느	which, how
어둡다	dark
어디	where
어떤	which, what
어떻게	how
어떻다	how
어떻습니까?	How is it?
어렵다	difficult
어른	adult
어리다	young
어린이	child
어머	oh, well
어머니	mother
어머님	mother
어서	hurry, quickly
어울리다	look good on, befit
어저께	yesterday
어제	yesterday
어젯밤	last night
언니	sister (as seen from the younger sister)
언제	when
언제나	always, anytime
얼굴	face
얼마나	how much
얼음	ice
엄마	mom
없다	none, no, not
없이	without
에어컨	air conditioner
엔	yen
엘리베이터	elevator
여권	passport
여기	here
여기저기	here and there
여덟	8
여동생	younger sister
여든	80
여러	various, many
여러가지	several, various
여러분	everyone, ladies and gentlemen
여름	summer
여보세요	hello
여섯	6
여자	woman
여학생	female student
여행	travel
여행사	travel agency, travel firm
역	station
역사	history
연락처	contact information
연세	age (honorific form)
연습	practice
연습하다	practice
연예인	celebrity
연필	pencil
연휴	consecutive holidays
열	10
열다	open
열리다	be opened
열쇠	key
열심히	hard, enthusiastic
열차	train
엽서	postcard
영	spirit, zero
영국	The United Kingdom
영상	video
영어	English
영어회화	English conversation
영하	minus, below zero
영화	movie
영화관	movie theater
영화배우	movie star
영화표	movie ticket
옆	side
예	yes
예문	example, model sentence
예쁘다	pretty, beautiful
예순	60
예약	reservation
옛날	a long ago, olden days
오	5
오늘	today
오다	come
오래	long, much
오래간만	after a long time
오래간만입니다	Long time no see.
오랜만	after a long time
오랜만에	after a long time
오랫동안	for a long time
오렌지	orange
오르다	climb
오른쪽	right side, right
오리	duck
오빠	brother (as seen from the younger sister)
오십	50
오월	May
오이	cucumber
오전	morning, a.m.
오징어	squid
오후	afternoon
올라가다	go up
올라오다	come up
올려놓다	put on, place
올림픽	olympic
올해	this year
옮기다	move, transfer, translate
옷	dress, clothes
옷가게	clothing store
옷장	closet
와이셔츠	shirt
왜	why
왜냐하면	because
외국	foreign country
외국어	foreign language
외국인	foreigner
외롭다	lonely
외삼촌	maternal uncle
외숙모	maternal aunt
외출하다	go out
외할머니	maternal grandmother
외할아버지	maternal grandfather
왼쪽	left
요금	fee
요르단	Jordan
요리	cooking, cuisine
요일	day of the week
요즘	nowadays, around this time, lately
우리	we, us
우리나라	our country, South Korea
우산	umbrella
우선	first
우유	milk
우체국	post office
우표	stamp
운동	exercise
운동복	sportswear, gym clothes
운동선수	athlete
운동장	playground, athletic field
운동하다	exercise
운동화	sports shoes
운전하다	drive
울다	cry
울리다	make cry, chime
움직이다	move
웃기다	funny, make someone laugh
웃다	laugh
원	won (currency units of Korea)
원피스	one-piece dress
원하다	want, wish, desire
월	month
월급	monthly salary
월드컵	world cup
월세	monthly rent
월요일	Monday
웬일	for some reason, What was it?
위	top, up
위치	location, position
위하다	for, in favor of, for the sake of
위험하다	dangerous
유럽	Europe
유리	glass
유명하다	famous
유월	June
유학	study abroad
유학생	foreign student, international student
유행	trend
육	6
육십	60
은행	bank
은행원	bank clerk
음료수	drink, soft drink
음반	record
음식	food, cooking
음악	music
음악가	musician
응	Yeah (answer)
의미	meaning
의사	doctor
의자	chair
이	this, tooth, 2
이거	this
이것	this
이곳	this place, here
이따가	later
이런	this, such ~
이렇게	like this, so, in this way
이렇다	like this
이름	name
이메일	e-mail
이모	maternal aunt
이모부	maternal uncle
이번	this time
이분	this person
이사	move, moving
이상	more than, strange
이상하다	strange, funny, weird
이십	20
이야기	story
이야기하다	talk
이용	usage
이용하다	use
이월	February
이유	reason
이제	now
이집트	Egypt
이쪽	this way, here, this person
이틀	two days
이해	understanding
이해하다	understand
인	sign, ~ person(s)
인구	population
인기	popularity
인기스타	popular star
인도	India
인사	greetings
인사하다	greet
인삼	ginseng
인상	impression
인천	Incheon
인터넷	internet
인터뷰하다	interview
인형	doll
일	work, 1, day
일곱	7
일기	diary
일기예보	weather forecast
일본	Japan
일본드라마	Japanese drama
일본말	Japanese language
일본사람	Japanese people
일본어	Japanese language
일본요리	Japanese food
일상생활	everyday life
일식	Japanese style, Japanese food
일어나다	rise, stand, occur
일어서다	get up, stand up
일요일	Sunday
일월	January
일주일	one week
일찍	early
일하다	work
일흔	70
읽기	reading
읽다	read
잃다	lose
잃어버리다	lose
입	mouth
입구	entrance
입다	put on, wear
입원하다	hospitalize
입학	admission
있다	have, there
잊다	forget
잊어버리다	forget
자	character, Here we go.
자기	myself, own
자다	sleep
자동차	car, automobile
자동차회사	car company
자료	material, document
자르다	cut
자리	seat, location
자신	myself, own
자연	nature
자유	freedom
자장면	Jajangmyeon
자전거	bicycle
자주	often
작년	last year
작다	small
작은아버지	uncle
작은어머니	aunt
잔	glass, ~ cup(s)
잔치	party, feast
잘	well
잘못	mistake
잘생기다	handsome
잘하다	do well, good at
잠	slumbers, sleep
잠깐	for a while, a little
잠시	for a bit, for a while, a little
잠자다	sleep, go to bed
잡다	catch, grab, hold
잡수시다	eat (honorific form)
잡지	magazine
장	~ chapter(s), ~ sheet(s)
장갑	gloves
장마	rainy season
장마철	rainy season
장미	rose
장소	place
장점	advantage
재료	material
재미없다	not funny, uninteresting
재미있다	interesting
재킷	jacket
저	that
저거	that
저것	that
저곳	over there
저기	there, over there
저녁	dinner, evening, night
저녁식사	dinner
저렇게	like that, in that way
저분	that person
저쪽	there, over there
저희	we
적	enemy
적다	be few, write down
전	all, before
전공	major
전기자동차	electric car
전자사전	electronic dictionary
전하다	tell
전혀	not at all
전화	telephone
전화기	telephone
전화번호	phone number
절	~ section(s), temple
절대	never, absolutely
젊다	young
점	point
점수	score, point
점심	lunch
점심시간	lunchtime
점심식사	lunch
점원	clerk
점퍼	jacket
젓가락	chopsticks
정거장	station, depot
정도	degree
정류장	station, bus stop
정리하다	straighten out, organize
정말	really, truly
정문	front door, main gate
정보	information
정하다	choose, establish
제가	I
제목	title
제일	most
제주도	Jeju Island
조금	a little
조사하다	investigate
조선	shipbuilding, Korea
조선말	Korean language
조선어	Korean language
조심하다	be careful, warn
조용하다	silent, quiet
조용히	quietly
조카	nephew
졸업	graduation
졸업하다	graduate
좀	a little
좀더	a little more
좁다	narrow
종로	Jong-ro
종류	kind, type
종업원	employee
종이	paper
종일	all day
좋다	good
좋아하다	like
죄송하다	sorry
주	week
주다	give
주로	mainly
주말	weekend
주머니	pocket, pouch
주무시다	sleep, rest
주문하다	order
주변	around
주부	housewife
주사	injection
주소	address
주스	juice
주위	around
주인	owner
주차장	parking lot
주차하다	park
주황색	orange color
죽	bamboo, porridge
죽다	die
준비	preparation
준비하다	prepare
줄	line, column, string
줄다	shrink, decrease
중	medium, during
중국	China
중국어	Chinese
중국집	Chinese restaurant
중식	Chinese cuisine
중심	center
중요	importance
중요하다	important
중학교	middle school, Junior high school
중학생	middle school student
즐거워하다	have fun
즐겁다	fun, be pleasant
즐기다	enjoy, have fun
증세	symptom, medical condition
지각	tardy, being late
지갑	wallet
지금	now
지나다	pass by
지난달	last month
지난번	last time
지난주	last week
지내다	stay, spend, live
지다	lose
지도	map
지방	fat, region
지우개	eraser
지키다	protect
지하	underground
지하도	underpass
지하철	subway
지하철역	subway station
직업	job, profession
직원	employee, staff
직장	workplace
직접	directly, direct
진달래	azalea
질	quality
질문	question
질문하다	ask a question
짐	load, baggage
집	house, shop
짓다	build, create
짜다	salty, make (the plan)
짜리	a value (won coin)
짧다	short
쪽	side, page
쯤	about, around ~
찌개	stew, soup
찍다	pierce, take (a photo), press
차	car, tea
차갑다	cold
차다	kick
차리다	prepare, arrange
착하다	be good, friendly
참	really, very
창문	window
찾다	find, visit
찾아가다	go to visit
찾아오다	come to visit
채소	vegetable
책	book
책방	bookstore
책상	desk
책임	responsibility
책장	bookshelf
처음	first, for the first time
처음 뵙겠습니다	Nice to meet you.
천	1000
천천히	slowly
철	iron, season
첫	first
첫째	first
청바지	blue jeans
청소기	vacuum cleaner
청소하다	sweep, clean
초	~second(s)
초대하다	invite
초등학교	elementary school
초등학생	elementary student
초록색	green color
초콜릿	chocolate
촬영하다	take a picture
최고	best, the highest
추다	dance
추석	Chusoku (Korean Thanksgiving Day)
추억	memory
축구	football, soccer
축제	festival
축하	celebration
축하하다	celebrate
축하합니다	congratulations
출구	exit
출근하다	go to work
출발	start, departure
출발하다	depart
출장	business trip
춤	dance
춤추다	dance
춥다	cold
취미	hobby
취소하다	cancel
취직하다	get a job
층	layer, ~ floor
치과	dentist, dentistry
치료하다	treat
치마	skirt
치약	toothpaste
친구	friend
친절하다	be kind
친척	relative
친하다	close, familiar
칠	7
칠십	70
칠월	July
칠판	blackboard
침대	bed
칫솔	toothbrush
카드	card
카레	curry
카메라	camera
카페	cafe, coffee shops
칼	knife, cutlery, swords
캐나다	Canada
커피	coffee
커피숍	coffee shop
컴퓨터	computer, PC
컵	cup
케이크	cake
켜다	turn on (the light, the power, etc.)
코	nose
코트	coat
코피	nosebleed
콜라	Coke
콧노래	humming
콧물	snot, nasal discharge
콩	bean, soy
크기	size
크다	big, large
크리스마스	Christmas
큰아버지	uncle
큰어머니	aunt
키	key, height
킬로그램	kilogram
킬로미터	kilometer
타다	ride, get on
타월	towel
탁구	table tennis
태국	Thailand
태권도	Taekwondo
태어나다	be born
태풍	typhoon
택시	taxi
탤런트	entertainers
터미널	terminal
테니스	tennis
테이블	table
텔레비전	TV
토마토	tomato
토요일	Saturday
통	barrel, ~ package(s)
통장	bank book, (deposit) passbook
통하다	pass, lead
퇴근하다	leave the office
특별히	especially
특징	characteristic, feature
특히	especially, in particular
틀다	turn on (the switch)
틀리다	wrong
티셔츠	t-shirt
팀	team
파	wave, green onion
파란색	blue color
파랗다	blue
파티	party
팔	8
팔다	sell
팔리다	sell, be sold
팔십	80
팔월	August
패션	fashion
퍼센트	percent
페이지	page
펜	pen
펴다	spread, stretch
편	side, episode
편지	letter
편하다	comfortable, easy, convenient
평양	Pyongyang
평일	weekday
포도	grape
포장	packing
표	table, ticket
표현	expression
푹	deeply
풀	pool, grass
풀다	solve
프랑스	France
프로그램	program
프린트	print
피	blood
피곤하다	tired
피다	bloom
피아노	piano
피우다	smoke, bloom
피자	pizza
필름	film
필요	necessity
필요하다	need
필통	pencil case
하나	1
하늘	sky
하늘색	sky blue, light blue
하다	do, say
하루	one day
하숙	boarding house, lodging house
하숙집	boarding house, lodging house
하얀색	white color
하얗다	white
하지만	but, however
학	crane
학교	school
학기	semester
학년	grade, school year
학생	student
학생증	student ID card
학원	academy, school
한	one, one of the ~
한강	Han River, Hangang
한국	Korea
한국드라마	Korean drama
한국말	Korean language
한국사람	Korean people
한국어	Korean language
한국요리	Korean cuisine
한글	Hangul
한번	once
한복	Hanbok, Korean traditional clothes
한식	Korean cuisine
한자	Chinese character
할머니	grandmother
할아버지	grandfather
할인	sale, discount
함께	together
합격	pass
항상	always
해	year, sun
해외	overseas
해외여행	overseas trip
핸드폰	cell phone, mobile phone
햄버거	hamburger
햇빛	sunshine, sunlight
행복	happiness
행복하다	happy
행사	event
허리	waist, hip
현금	cash
현재	now, current
형	brother (as seen from the younger brother)
형님	big brother (honorific form)
형제	sibling
호	No. ~
호랑이	tiger
호주	Australia
호텔	hotel
혼자	alone
홈페이지	home page
홍차	black tea
화	anger
화가	artist, painter
화나다	angry
화내다	get angry
화요일	Tuesday
화장실	restroom, toilet, lavatory
화장품	cosmetics
화장하다	makeup
확인하다	confirm, check
환영하다	welcome
환자	patient
회사	company
회사원	employee
회색	grey
회의	conference
횡단보도	crosswalk
후	after
후배	Junior
휴가	vacation, holiday
휴대전화	cell phone, mobile phone
휴일	holiday
휴지	toilet paper
휴지통	trash can
흐리다	cloudy
흰색	white color
힘	power
가계부	household account book
가구점	furniture store
가까이	near
가꾸다	to cultivate
가난	poverty
가늘다	to be thin
가능	possibility, potentiality
가능성	possibility
가능하다	to be possible
가득	full
가라앉다	to sink
가렵다	to be itchy
가루비누	powder soap
가리다	to distinguish
가리키다	to indicate
가만히	motionlessly
가뭄	drought
가사	housework
가상	virtual
가스	gas
가습기	humidifier
가입	entry
가전제품	home appliances
가정	family
가족적	being family-oriented
가축	livestock
가치	value
각각	separately, each
각자	each one
각종	various
간격	interval
간절히	eagerly
간접적	being indirect
간판	signboard
간호	nursing
갈다	to change
갈등	conflict
갈수록	more and more
갈아입다	to change clothes
감각	sense
감기다	to be twined
감독	director
감동적	moving (emotionally)
감상	appreciation
감소	reduction
감정	emotion
감탄	admiration
강물	river water
강변	riverside
강사	teacher
강수량	rain precipitation
강연	lecture
강우량	(the amount of) rainfall
강의	lecture
강의실	lecture hall
강조	emphasis
강하다	to be strong
갖추다	to prepare
갚다	to return, to reward
개강	start of course (lecture)
개구리	frog
개구쟁이	naughty child
개다	to clear up
개막식	opening ceremony
개발	development
개방	opening, opening to the public
개방적	being open
개선	improvement
개성	individuality
개성적	being characteristic
개인적	being personal
개최	hosting (an event)
객관적	being objective
객실	guest room
갸름하다	to be slim and long
걔	that person
거래	transaction
거미	spider
거북이	turtle
거스름돈	change
거절	rejection
거짓	lies
거치다	to go through
거품	bubble
걱정거리	worries
건강식	healthy diet
건강식품	healthy food
건너	across
건네다	to hand over, to start (a conversation)
건더기	solid ingredients of a soup
건망증	forgetfulness
건설	construction
건전지	batteries
건조	dry
건축	architecture
건축가	architect
걸레	rag
걸레질	mopping
걸음	steps
검다	black
검사	inspection
검색	search
검색어	search word
겁	fear
겉	side, outside
겉모습	appearance
게다가	besides, in addition
게시판	bulletin board
게으르다	to be lazy
게임기	game machine
겨우	barely, finally
격려	encouragement
겪다	to experience, to go through
견디다	to endure
결과적	being as a result
결국	after all
결론	conclusion
결말	end (of a story)
결석	absence
결승전	final game/round
결심	decision
결코	never
결혼기념일	wedding anniversary
결혼식장	wedding hall
겸손	humility
겹치다	overlap
경고	warning
경력	career
경비	security
경비원	security guard
경영	management
경영자	executive, CEO
경영학	business administration
경우	case, circumstance
경쟁	competition
경쟁력	competitiveness
경제	economy
경제력	economic power
경제적	being economic
경제학	economics
계산	calculation, accounting
계산대	cashier
계산서	check, bill
계약	contract
계약금	down payment
계약서	(written) contract
계좌	bank account
계층	hierarchy
계획성	planning
계획적	being planned, as planned
고개	head, hill
고객	client, customer
고구마	sweet potato
고궁	traditional Korean palace
고급	high grade
고래	whale
고마움	thankfulness
고무신	rubber shoes
고무줄	rubber band
고민	worry, trouble
고백	confession
고생	hardship
고소하다	to be nutty
고속	high speed
고속도로	highway
고아원	orphanage
고유하다	unique
고지서	notice
고집	persistence
고춧가루	pepper powder
고층	upper floors
고통	pain
곤란	difficulty
골고루	evenly
골목길	alley
골치가 아프다	to be annoying
곰	bear
곱슬머리	natural curly hair
곳곳	here and there, everywhere
공공요금	utility charges
공공장소	public place
공동	joint
공동생활	community life
공사	construction
공손하다	to be polite
공연장	performance hall
공장	factory
공주	princess
공통	common
공통점	common point
공포	fear
공해	pollution
과로	overwork
과목	(class) subject
과소비	waste (of use)
과속	speed violation
과식	overeating
과연	as expected
과외	tutor lesson
과음	excessive drinking
과장	manager
과장하다	to exaggerate
과정	process
과제	task
과학자	scientists
과학적	being scientific
관객	audience
관계없다	to be unrelated
관계자	the person concerned
관광	tourism
관광객	tourist
관광지	tourist attraction
관람	viewing
관람객	audience
관련	relation
관련성	relevance
관리	management
관리실	management room
관용어	idiom
관찰	observation
광장	square, plaza
괜히	for no reason
괴로움	agony, distress
괴로워하다	to be distressed
괴롭다	to be painful
괴롭히다	to harass, to bully
굉장하다	to be great, to be wonderful
굉장히	extremely, to a great extent
교사	teacher
교외	suburbs
교육	education
교육자	educator
교육학	pedagogy
교재	teaching materials
교통수단	transportation
교통편	transportation
교포	overseas resident
교환	exchange
구두쇠	a stingy person
구르다	to roll
구매	purchase
구멍	hole
구별	distinction
구분	classification
구성	composition
구이	grill
구인	a job offer
구입	purchase
구조	structure
구조대	rescue team
구체적	being specific
국가	nation
국그릇	soup bowl
국내선	domestic flights
국문학	(the country's) literature
국물	soup bowl
국민	citizens
국악	traditional Korean music
국외	overseas resident
국제결혼	international marriage
국제선	international flights
국화	chrysanthemum
군대	army
군데	place
굵다	to be thick
궁금증	curiosity
궁금하다	to be curious
권하다	to recommend, to offer
귀걸이	earrings
귀국	return (to home country)
귀신	ghost
귀중하다	to be valuable
귀찮다	to be bothersome, to be tedious
귀하다	to be noble, to be rare, to be fine
규칙적	being regular
그네	swing
그녀	girlfriend
그늘	shade
그대로	as it is
그래도	(but) still
그래야	so that
그래프	graph
그러니	therefore
그러다가	and then
그러므로	hence
그러자	and then
그러하다	so, as such, like that
그루	(how to count trees), stump
그룹	group
그리	so, very, that
그리워하다	to miss, to be nostalgic
그리하여	then
그림책	picture book
그립다	to be nostalgic, to be missed
그만두다	to quit
그만큼	that much
그저	just
근데	by the way
근로자	worker, laborer
근무	work
근육	muscle
글쎄	oh well
글쓴이	author
글씨	letter
글자	letter
긁다	to scratch
금	gold
금메달	gold medal
금액	amount of money
금지	ban
급히	suddenly
긍정적	being positive, being affirmative
기계	machine
기념	commemoration
기념관	memorial hall
기념일	anniversary
기념품	souvenir
기능	function
기다	to crawl
기대	expectation
기도	prayer
기둥	pillar
기록	record
기본	basic
기본적	being fundamental, being basic
기부	donation
기쁨	joy, happiness
기술	skill, technique
기술자	technician
기억	memory
기억나다	to remember, to recall
기억력	memory
기업	company, corporation
기업인	entrepreneur
기운	energy, qi
기울이다	to tilt
기준	standard, criteria
기차역	train station
기차표	train ticket
기초	basic, fundamental
기행문	travelogue, travel essay
기호	symbol
기혼	married
기회	opportunity, change
기후	climate
긴장감	nervousness
길가	roadside
길거리	street
길이	lenth
김장	a custom/event to make Kimchi in winter
깊다	to be deep
깊이	depth
까다	to peel
까다롭다	to have a high standard
깔다	to lay
깜빡	forgetfully, with a blink
깨끗이	clearly
깨닫다	to realize
깨뜨리다	to break
깨소금	sesame salt
깨우다	to wake someone up
깻잎	sesame leaf
꺼지다	to go out, to be extinguished
껍질	peel, skin
꼬리	tail
꼬박꼬박	properly (without failure), faithfully
꼭대기	summit, top
꼴찌	the last place
꼼꼼하다	to be meticulous
꼼꼼히	thoroughly, meticulously
꽃병	flower vase
꽤	quite
꾸미다	to decorate
꾸준히	steadily
꾸짖다	to scold
꿀	honey
꿀벌	honey bee
꿈꾸다	to dream
끈	string
끊다	to cut
끊어지다	to be cut
끊임없다	to be incessant, to be unceasing
끌다	to pull
끝내	finally, eventually
끼어들다	to interrupt
나날이	day by day
나들이	picnic
나름	depends on
나머지	remainder, surplus
나물	(Korean style) seasoned vegetables
나뭇잎	leaf
나서다	to go forward, to get involved
나아가다	to move on
나아지다	to improve
나타내다	to display, to reveal
낙서	doodle
낙엽	fallen leaves
난로	stove, fireplace
난방	heater
날개	wings
날다	to fly
날로	day by day
날리다	to blow away
날씬하다	skinny
날아가다	to fly away
날아다니다	to fly around
날아오다	to fly in
날아오르다	to fly up, to soar
낡다	to be old
남녀노소	men and women of all ages
남녀평등	gender equality
남다	to remain, to be left
남부	southern
남성	male
남성복	men's clothing
낫다	to heal
낭비	waste (of use)
낯설다	to be unfamiliar
낳다	to give birth
내내	always
내려다보다	to look down
내복	underwear
내부	inside, internal
내성적	being shy
내용물	content (of a container)
내쫓다	to kick out
냇가	stream, lake
냉방병	excessive air conditioning syndrome
너그럽다	to be generous
너무나	too~, very
넉넉하다	to be enough, to be rich
널다	to dry, to expose to the air
넓히다	to widen
넘기다	to hand over
넘어가다	to move on to
넘치다	to overflow
네모나다	to be squared
네트워크	network
년대	age
노동	labor
노동자	laborer
노력	effort
노선	route, line
노약자	elderly and physically handicapped
노인	elderly
노처녀	an unmarried and old woman
노총각	unmarried and old man
노트북	laptop
녹다	to be melt
녹음	voice recording
녹음기	voice recorder
논문	(academic) paper
놀랍다	to be amazing, to be remarkable
놀리다	to make fun of
놀이	play, game
놀이터	playground
놈	guy
농담	joke
농민	farmer
농부	farmer
농사	agriculture
농약	pesticides
농작물	crops
농촌	rural
높이	height
높이다	to increase
높임말	honorifics
놓이다	to be placed
놓치다	to miss, to lose
눈길	glance, attention
눈높이	eye-level
눈병	eye disease
눈보라	snowstorm
눈사태	avalanche
눈썹	eyebrow
눈치	wits, sense
눌러쓰다	to wear deeply
느긋하다	to be lazy, to be laid back
느끼하다	to be greasy
늘리다	to increase (the number or volume)
늘어나다	to stretch, to increase
늘어서다	to line up
늙다	to get old
늦추다	to delay
다가오다	to approach, to come closer
다녀가다	to visit
다람쥐	squirrel
다루다	to deal with
다림질	ironing
다수	many
다양하다	to be varied
다음날	next day
다정하다	to be compassionate, to be kind
다투다	to argue, to fight
다행	fortune, luck
다행히	fortunately
단계	stage, step
단골	regular (customer)
단기간	short term
단단하다	to be solid, to be hard, to be strong
단발머리	(women's) short hairstyle
단백질	protein
단속	control, regulate (illegal action)
단순하다	to be simple
단순히	simply
단위	unit
단정하다	to be neat, to be organized
단체	group
단풍	autumn leaves, maple
달라지다	to change
달려가다	to run (to go)
달려오다	to run (to come)
달리	besides, differently
달리기	running
달밤	moonlit night
달아나다	to escape
달콤하다	to be sweet
닭갈비	Korean style chicken dish
담	wall, fence, hedge
담기다	to be put in (a container)
담다	to put in (a container)
담당	being in charge
담당자	person in charge
담백하다	to be pure, to be innocent
담뱃불	tobacco fire
담임	homeroom teacher
답	answer
답글	reply
답답하다	to be stuffy, to be suffocating
답변	answer
당기다	to pull
당분간	for a while (from now on)
당연하다	to be natural,to be justifiable,to be fair
당연히	of course
당장	immediately, for now
당하다	to be done
당황하다	to be embarrassed, to be bewildered
대개	mostly, usually
대기업	large company
대다	to touch
대단하다	to be great
대단히	greatly
대도시	big city
대량	mass, a large amount
대리	substitute
대문	door, gate
대신	in substitute
대여	rental
대여료	rental charge
대접	hospitality
대중	public
대중교통	public transportation
대중목욕탕	public bath
대책	countermeasures
대청소	housecleaning
대체로	usually, in general
대출	loan, lend
대통령	president (of a country)
대표	representative
대표적	being representative, being typical
대형	large size
댄스	dance
더구나	furthermore, moreover
더러워지다	to get dirty
더욱	even more
더위	heat, hotness
더하다	to add on, to get worse
덕	thanks (to someone)
던지다	to throw
덜	less, not yet
덜다	to cut back
데다	to get burned
데려오다	to bring
데치다	to boil quickly
도구	tool
도난	theft
도대체	how on earth
도둑	thief
도망가다	to escape, to run away
도서	books
도시락	lunchbox
도장	seal, stamp
도전	challenge
도중	on the way
독	poison
독감	influenza, flu
독립	independence
독방	room to oneself, solitary confinement
독신자	an unmarried, single person
독특하다	to be unique
돌	stone, rock
돌다	to spin, to get around
돌려받다	to get returned
돌려보내다	to return
돌려주다	to return
돌리다	to turn
돌보다	to take care
돌솥	stone pot
돌아다니다	to walk around
돌아보다	to look back
돌아서다	to turn back
돌잔치	1st birthday
동굴	cave
동료	colleague
동물원	zoo
동부	eastern part
동서양	eastern and western
동시	simultaneous
동양화	oriental painting
동영상	video
동일하다	being the same
동작	motion, action
동창	alumni
동창회	alumni association
동해안	east coast
동호회	club
동화	fairy tale
동화책	children's book
되도록	as much as possible
되돌리다	to regain
되돌아보다	to look back, to think back
되살아나다	to revive
두려움	fear
두려워하다	to fear
두세	two, three
두통	headache
두통약	headache pill/medicine
둔하다	to be dull
둘러보다	to look around
둥글다	to be round
뒤떨어지다	to be inferior, to be behind
뒤집다	to flip
뒤풀이	after-party
뒷모습	the back view
뒷문	back gate
뒷이야기	behind story
뒷자리	back seat
드디어	finally
드라이	dry
드림	dream
드물다	to be rare
든든하다	to be reassuring, to be reliable
들려주다	to tell (someone)
들르다	to stop by
들리다	to be heard
들어보다	to try hearing
들어주다	to listen (to someone)
들이다	to spend (time, money)
등록	register
등록금	registration fee, tuition fee
등록증	registration card
등불	lights, lamp
디스크	disc, hernia
디자이너	designer
디지털	digital
따다	to pluck, to pick, to get
따라다니다	to follow (after someone)
따라서	therefore, hence
따로따로	separately
따지다	to question closely
딱	perfectly, just
딱딱하다	to be hard, to be stiff
딴	another, other
땅	land, ground
땅콩	peanuts
때때로	sometimes
때로	now and then
떠오르다	to float
떨다	to shiver, to shake
떨리다	to tremble, to be shaken
떨어뜨리다	to drop
떼다	to detach, to take away
또박또박	word by word, letter by letter
또한	also
똑같이	similarly, in the same manner
똑똑하다	to be clever, to be smart
뚜렷하다	to be clear
뚫다	to make a hole
뚱뚱하다	to be fat
뛰어가다	to run
뛰어나다	to be superior
뛰어내리다	to jump off
뛰어넘다	to jump over
뛰어다니다	to jump around, to run around
뛰어오다	to run (to come)
뛰쳐나가다	to rush out, to leap out
뜨거워지다	to become hot
뜻밖에	unexpectedly
띠	zodiac
램프	lamp
레몬	lemon
레포츠	leisure sports
렌즈	lens
렌터카	car rental
로또	lottery
로봇	robot
로비	lobby
룸메이트	roommate
리듬	rhythm
리모컨	remote controller
마감일	deadline, due date
마네킹	mannequin
마당	garden
마디	section
마라톤	marathon
마련하다	to provide, to prepare
마루	indoor floor
마무리	conclusion
마술	magic
마스크	mask
마약	drug
마을	village
마음껏	as much as one wants
마음대로	as one wishes
마음먹다	to make up one's mind
마음씨	mindfulness
마주보다	to come face to face
마주치다	to meet (coincidentally)
마중	pick up
마찬가지	being the same, in the same manner
마치	as if, just like
마침	just happened to be
마침내	finally
마케팅	marketing
마트	supermarket
막	insanely, do something without any order
막내	the youngest
막다	to block
막대기	rod, stick
막차	last train
만남	encounter, meeting
만년필	fountain pen
만약	by any chance
만족	satisfaction
만족감	satisfaction (feeling)
만화책	cartoon book
맏딸	eldest daughter
맏아들	eldest son
말다툼	quarrel
말리다	to stop (conflict)
말투	the way one speaks
맛보다	to taste
망가뜨리다	to break, to ruin
망가지다	to be broken, to be ruined
망설이다	to hesitate
망하다	to perish, to breakdown
맞벌이	dual-income family
맞이	greeting
맞추다	to assemble
맡기다	to entrust
맡다	to take over, to undertake
매년	annually, every year
매달	monthly, every month
매력	attraction
매력적	being attractive
매연	soot
매운탕	spicy fish soup
매점	shop
매진	sold out
매체	medium
매콤하다	to be sweet and spicy
매표소	ticket office
맨발	barefoot
맨손	bare hands
맹인	blind person
맺다	to tie
머리카락	hair
머무르다	to stay
머지않다	to be not distant
먹을거리	food
먹이	(animal) feed
먹이다	to feed
먼지	dust
멀리	far away
멀티미디어실	multimedia room
멈추다	to stop
멋지다	to be fantastic, to be amazing
멍	bruise
메일	e-mail
멜로디	melody
멜론	melon
며느리	daughter-in-law
면	side, noodles
면세점	duty-free shop
면접	interview
면접관	interviewer
면접시험	interview test
면허증	license
명랑	cheerfulness, brightness
명랑하다	to be cheerful, to be bright
명사	noun
명소	famous place
명품	masterpiece, designer goods
몇몇	some, few
모국어	native language
모기	mosquito
모델	model
모래	sand
모범생	model student
모습	appearance
모음	vowel
모자라다	to be insufficient
모집	recruitment
모험심	adventurous mind
모형	model, figure
목마르다	to be thirsty
목사	pastor
목숨	life
목욕탕	public bath
목적지	destination
목표	target, goal
몰라보다	to be unaware of, to not realize
몰래	secretly
몰려들다	to gather
몰리다	to get crowded
몸무게	bodyweight
몸짓	gesture
몹시	very, terribly
못생기다	to be ugly
무게	weight
무관심	indifference
무너지다	to collapse, to be pulled down
무늬	pattern
무대	(performance) stage
무더위	extreme heat (in summer)
무덤	tomb
무덥다	to be hot and humid
무렵	around (the time)
무사히	safely
무서워하다	to be scared
무선	wireless
무소식	no news
무시	disregard, neglect
무인	unmanned, no person
무조건	absolutely
무지개	rainbow
무통장 입금	electronic transfer, ATM deposit
묵다	to stay (at a hotel)
묶다	to bundle, to tie
문구	stationery
문명	civilization
문법	grammar
문병	a visit to a sick person
문서	documents
문의	inquiry
문자	SMS, short messages, letters
문제점	problem
문학	literature
문화생활	cultural life
문화유산	cultural heritage
문화적	being cultural
묻히다	to put on, to get buried
물가	price
물고기	fish
물냉면	Korean cold noodle
물다	to bite
물러서다	to step back, to withdraw
물려주다	to pass on, to leave
물리다	to be stung, to get bitten
물방울	water drop
물약	liquid medicine
물음	question
물질	quality
물품	product, goods
뮤지컬	musical
미끄러지다	to slide
미끄럽다	to be slippery
미루다	to procrastinate, to extend
미소	smile
미역	seaweed
미역국	seaweed soup
미용사	barber
미인	beautiful woman
미치다	to go mad, to be crazy
미팅	blind date
미혼	an unmarried, single person
민박	lodge, a local hotel
민속	folklore
민속놀이	folk play
민요	folk song
민족	ethnic group
믿다	to believe in
믿음	trust, faith
믿음직스럽다	to be reliable
믿음직하다	to be trustworthy
밀다	to push
밀려오다	to rush in, to be pushed into
밀리미터	millimeter
밉다	to hate, to be annoying
및	and
밑줄	underline
바가지	gourd
바구니	basket
바깥	outside, outdoor
바느질	needlework
바늘	needle
바닥	bottom, floor
바닥나다	to run out
바닷물	seawater
바둑	game of go
바라보다	to look at
바보	idiot, stupid
바위	rock, stone
바이러스	virus
바퀴	wheels
바탕	background, foundation
박사	doctoral degree, Ph.D.
박스	box
반가워하다	to be pleased, to be glad
반납	return
반납일	return date
반대	opposite
반대말	opposite word
반대쪽	opposite side
반드시	without fail, certainly
반말	casual talk
반복	repeat
반성	introspection, self-contemplation
반응	reaction
반짝반짝	shiny, sparkly
반짝이다	to shine, to glitter
반품	refund
반하다	to fall in love
받아들이다	to accept
발걸음	footsteps
발견	discovery
발급	issuance
발달	development
발레	ballet
발명	invention
발목	ankle
발생	occurrence
발자국	footprints
발표자	presenter
발표회	presentation
밝히다	to reveal, to disclose
밟다	to step on
밤새	all night, during the night
밤새우다	to stay up all night
밥그릇	rice bowl
밥맛	appetite, the taste of rice
밥상	table for having a meal
방금	just now
방문	visit
방송사	broadcasting company
방식	method, style
방청객	audience
방해	interference, interruption
방향	direction
밭	(farm) field
배경	background
배꼽	belly button
배낭	backpack
배낭여행	backpack trip
배려	consideration
배우자	spouse
배추	cabbage
배터리	battery
뱀	snake
뱉다	to spit out
버릇	habit, manner
버릇없다	to have bad manners
버섯	mushroom
버튼	button
번역	translation
번호표	number ticket
벌금	fine
벌리다	to open, to spread
벌집	honeycomb
범위	range
범인	criminal, offender
범죄	crime
법	law
법원	court of law
벗기다	to take off (clothes)
벗어나다	to get out
베개	pillow
벨	bell
벨트	belt
벼	rice plant
벼락	thunder
벼룩시장	flea market
벽걸이	wall-hanging
벽돌	brick
변경	change, alter
변기	toilet bowl
변명	excuse
변비	constipation
변하다	to change
변화	change
별명	nickname
별일	something else, something that has changed
병문안	a visit to a sick person
보고	report
보고서	(written) report
보고회	reporting/briefing session
보관	storage
보관실	storage room
보기	example, sample
보너스	bonus
보람	the feeling of reward
보름	the fifteenth day of the calendar
보름달	full moon
보물	treasure
보살피다	to take care of
보약	supplement, acupuncture medicine
보증금	deposit
보충	replenishment
보험	insurance
보험금	insurance money
보험료	insurance fee
보호	protection
복	fortune
복권	lottery
복날	the day of the year to eat nourishing food
복도	corridor, hallway
복사	copy
복사기	copy machine
복습	review
복통	stomach ache
본론	main discussion topic
본문	the original literature
볼거리	highlights/fun things to see
볼륨	volume
볼링	bowling
볼링장	bowling gym
볼일	errand
봉사	volunteer
봉사자	volunteer person
부끄러워하다	to be ashamed of
부끄럽다	to be shy, to be ashamed
부담	burden, pressure
부딪치다	to collide
부딪히다	to get collided
부러워하다	to feel jealous
부러지다	to get broken
부럽다	to be envious of
부분	part
부사	advert
부상	injury
부상자	injured person
부서	department
부서지다	to be shattered
부자	rich person
부작용	side effects
부잣집	rich family
부정적	being negative
부족	being not enough, lacking
부주의	carelessness
부지런히	eagerly, diligently
부채	fan
부케	bouquet
부피	size, volume
분량	quantity
분리	separation
분리수거	garbage recycling
분명하다	to be distinct, to be clear
분명히	clearly, explicitly
분실	loss
분실물	lost and found
분홍색	pink color
불가능	impossibility
불가능하다	to be impossible
불경기	economic depression
불교	buddhism
불규칙	irregularity
불꽃놀이	firework
불량	defective product, misconduct
불만	dissatisfaction
불면증	insomnia
불법	illegal
불빛	flame, light
불쌍하다	to be pathetic
불안	anxiety
불안감	an anxious feeling
불어나다	to increase, to become bigger
불친절	to be unkind
불태우다	to burn
불편	inconvenience
불평	complaints
불필요	unnecessary
불행	misfortune
붉다	to be red
붐비다	to be crowded
붕어빵	baked bread with red beans inside (street food)
붙잡다	to catch
붙잡히다	to get caught
뷔페	buffet
브랜드	brand
브레이크	brake
블라인드	blind
블로그	blog
비교	comparison
비교적	being comparative
비닐	vinyl
비다	to be vacant, to be empty
비디오카메라	video camera
비록	even if
비만	obesity
비바람	rain and wind, typhoon
비비다	to mix, to rub
비빔냉면	Korean style cold noodles with spicy sauce
비상약	emergency medicine
비용	cost
비우다	to make something empty
비자	visa
비추다	to illuminate
비타민	vitamin
비하다	to compare
빗길	rainy road
빚	debt
빛	light
빠뜨리다	to drop
빠지다	to fall in love, to sink down
빠짐없이	all without exception
빨개지다	to get red
빼앗기다	to be taken away
빼앗다	to take away
뺨	cheek
뻔하다	to be obvious, to be clear
뻗다	to extend
뽑다	to pull out, to choose
뿌리	root
뿌리다	to spray, to spread
사건	incident
사고방식	way of thinking
사교적	being sociable
사귀다	to date
사라지다	to disappear
사로잡다	to capture
사막	desert
사망	death
사망자	the dead, casualty, victim
사모님	wife (of a boss)
사무소	office
사생활	privacy
사슴	deer
사실	fact
사업	business
사용료	usage fee
사용법	how to use
사우나	sauna
사은품	appreciation gift, gift
사이버	cyber
사이좋다	to be in a good relationship
사이트	website
사정	circumstances, situation
사진관	photo studio
사진첩	photo album
사춘기	puberty
사투리	dialect
사표	resignation
사회	society
사회생활	social life
사회자	moderator, chairperson
사회적	being social
산꼭대기	mountain summit
산더미	pile
산부인과	obstetrics and gynecology
산불	forest fire
산업	industry
산책로	walking path
살리다	to keep someone alive, to bring someone to life
살림	living
살아가다	to live
살아나다	to be saved
살아남다	to survive
살아오다	to come alive
살인	murder
살짝	slightly, quietly
살찌다	to get fat
살펴보다	to explore, to observe
살피다	to explore, to observe
삶	life
삶다	to boil
삼겹살	grilled pork belly
삼일절	Korean independence movement day
삼키다	to swallow
상	prize, reward
상가	shopping street, shopping district
상관없다	to have no relation
상관없이	regardless
상금	prize money, reward
상담	consultation, counseling
상담실	counseling room
상담원	counselor
상담자	consultant
상당히	fairly, pretty
상대	opponent
상대방	opponent
상대편	the other person
상상	imagination
상상력	imagination
상승	rise, increase
상식	common knowledge, common sense
상업	commerce
상업적	being commercial
상인	merchant
상점	store
상징	symbol
상쾌하다	to feel cool and fresh
상태	status
상표	label
상품권	gift certificate
상하다	to get rotten, to get damaged
상황	situation, status
새다	to dawn
새롭다	to be new
새어머니	stepmother
새우다	to stay overnight
새치기	cutting line/que
새해	new year
색다르다	to be eccentric, to be unique, to be new
색상	color
생각나다	to remember, to recall
생강차	ginger tea
생겨나다	to emerge, to occur
생김새	appearance
생략	omission, deletion
생머리	straight hair
생명	life
생산	production
생생하다	to be fresh
생중계	live broadcast
생필품	daily necessities
생활비	cost of living, living stipend
생활수준	quality of living
서너	three or four
서두르다	to hurry, to rush
서랍	drawer
서론	introduction
서명	signature
서부	western
서빙	serving
서서히	gradually
서운하다	to be sorry, to be remorseful
서투르다	to be clumsy, to be unskilled
석사	master's degree
석식	dinner
석유	oil, petroleum
석탄	coal
섞다	to mix, to rub
선	line
선글라스	sunglasses
선선하다	to be cool, to be chilly
선진국	developed country
선착순	order of arrival
설	theory
설득	persuasion
설마	no way
설명서	manual
설문조사	questionnaire
설문지	questionnaire
설사	even if, for example, diarrhea
섭섭하다	to be sorry, to be regrettable
성공	success
성능	performance, function
성당	catholic church
성명	statement, signature
성별	gender
성실	diligent
성인	adult
성인병	adult diseases, lifestyle diseases
성적	grades
성적표	grade report card
성형	plastic surgery
세계적	being global, being worldwide
세금	tax
세기	century
세다	to count
세대	generation
세련	sophistication
세면대	washbasin, sink
세면도구	toiletries, washing accessories
세미나	seminar
세배	triple, 3 times
세뱃돈	new year's money
세상	world
세월	years
세제	detergent
세탁물	laundry
셔츠	shirt
셔틀버스	shuttle bus
소감	thoughts, feelings
소개팅	blind date
소규모	small scale
소극장	small theater
소극적	being passive
소나기	(sudden) shower/rain
소년	young boy
소득	income
소망	hope
소매	sleeve
소매치기	pickpocketing
소문	rumors, reputation
소방관	firefighter
소방서	fire department
소방차	firetruck
소비	consumption
소비자	consumer
소설책	novel
소수	minority, a small number
소스	sauce
소심하다	to be timid, to be cowardly
소용	way of use
소용없다	useless
소원	wish
소음	noise
소주	soju, a Korean liquor
소중하다	to be important
소중히	valuably, carefully
소화	digestion
속다	to be tricked
속담	proverb
속도	speed
속도위반	speed violation
속력	speed
속상하다	to be annoying, to be regretful, to be sad
속옷	underwear
속이다	to deceive
손바닥	palm
손발	hands and legs
손쉽다	to be easy
손자	grandson
손잡이	handle, rail
손질	trimming, repair
솔직하다	to be honest
솔직히	honestly, frankly
솜씨	skill, tricks
송금	money transfer
쇠	iron
쇠고기	beef
쇼	show
쇼핑몰	shopping mall
쇼핑백	shopping bag
쇼핑센터	shopping center
수거	pickup, collection
수고	hardship, hard work
수단	means, method
수도꼭지	water faucet
수량	quantity, amount
수료식	completion ceremony
수리	repair
수리비	repair cost
수면	sleep
수면제	sleeping pills
수명	lifespan
수산물	seafood
수상	prime minister
수선	repair (clothes)
수선하다	to repair (clothes)
수수료	commission, fee, charge
수입	import, income
수정	revision, crystal
수준	level
수집	collection
수출	export
수표	(money) check
수학여행	school excursion
숙녀복	women's clothing
숙박	lodging, accomodating
숙박비	accommodation fee
숙소	accommodation
숙이다	to get low, to bend low
순간	moment
순두부찌개	Sundubu soup
술자리	drinking party
술잔	glasses, cup
술집	bar
숨기다	to hide (something)
숨다	to hide
숫자	numbers
숲	forest
스님	buddhist monk
스스로	by oneself
스캐너	scanner
스타일	style
스티커	stickers
스프	soup
스피커	speaker
슬리퍼	slipper
슬픔	sorrow, sadness
습기	moisture
습도	humidity
승강기	elevator
승객	passenger
승리	victory
승용차	passenger car
승진	promotion
승차	riding, boarding
시각	visual sense
시대	era, generation
시도	attempt, trial
시력	sight
시리다	to feel a chill, to be painfully cold
시부모님	parent-in-law
시스템	system
시아버지	father-in-law
시어머니	mother-in-law
시외버스	intercity bus
시인	poet
시집	poetry collection, marriage (for women)
시집가다	to get married (for women)
시청각실	multimedia room
시청자	audience, viewer
시합	competition, match
시험공부	studying for an exam
식	formula, method
식구	familly
식료품	grocery
식물	plant
식물원	botanical garden
식비	food expenses
식생활	diet
식습관	eating habits
식욕	appetite
식용유	cooking oil
식초	vinegar
식품	food
식후	after a meal
신고	report
신기다	to make someone wear (shoe)
신기술	new technology
신기하다	to be mysterious, to be amazing, to be marvelous
신나다	to be excited, to have fun
신도시	new city
신랑	groom
신랑감	groom candidate
신문사	newspaper company
신문지	newspaper
신부	bride, father (christianity)
신분증	identification document
신상품	new item
신선하다	to be fresh
신세대	new generation
신용	credit, trust
신입생	freshmen
신제품	new product
신청자	applicant
신체	body
신형	new model
신호	signal
신혼	newly married
신혼부부	newlyweds, newly-married couple
신혼여행	honeymoon
싣다	to put on, to pile on
실	yarn, thread
실내	indoor
실력	ability
실망	disappointment
실시	implementation
실용적	being practical
실은	in fact, actually
실제	in fact, actually
실제로	in fact, actually
실종	disappearance, missing
실종자	missing person
실천	(put into) practice, action
실컷	as much as one wants
실크	silk
실패	failure
실험	experiment
실험실	laboratory
싫증	to get sick of, to get tired of
심각하다	to be serious
심다	to plant
심리학	psychology
심리학자	psychologist
심부름	errand
심심하다	to be bored
심장	heart
심장병	heart disease
싱싱하다	to be fresh, to be lively
싱크대	sink
싸구려	cheap thing
싸움	fight
쌀쌀하다	to be chilly
쌍둥이	twins
쌓다	to stack, to build
쏘다	to shoot
쏟다	to spill
쏟아지다	to spill, to pour, to fall heavily
쑥스럽다	to be shy
쓰러지다	to fall, to collapse
쓰레기통	trash can
쓸데없다	to be needless, to be useless
쓸데없이	uselessly, unreasonably
쓸쓸하다	to be lonely
씌우다	to cover
씨름	Sireum, Korean Sumo
씩씩하다	to be reliable, to be strong
아깝다	to be regrettable, to be precious
아끼다	to save, to be frugal
아나운서	announcer
아니	no
아동	child
아랫사람	one's junior, one's subordinate
아르바이트	part-time job
아리랑	Arirang (Korean traditional song)
아무것	any, what
아무래도	anyhow, whatever
아무런	any sort of, in any way
아무리	no matter how
아무튼	anyway
아쉬움	frustration, regret
아쉽다	to be unsatisfied, to be sorry
아이디	username, ID
아이디어	idea
아침저녁	morning and evening
아픔	pain
악몽	nightmare
악수	handshake
안개	fog
안과	ophthalmology
안내문	announcement, notice
안내서	guidebook, handbook
안내소	information office
안되다	to fail, to not go well
안방	master's bedroom
안부	news, regards
안색	complexion
안심	relief
안약	eye drop
안전선	safety line
안주	snack (served with alcoholic beverages)
안쪽	inside
안타깝다	to feel sorry
앉히다	to let/make someone sit down
알	egg, ball
알레르기	allergy
알아듣다	to understand
알아보다	to recognize
알아주다	to admit, to accept
알약	tablet medicine
알코올	alcohol
암	cancer
앞날	future
앞두다	to have something ahead
앞뒤	before and after
앞머리	(hair) bangs
애기	baby
애완견	pet dog
애완동물	pets
애인	lover
애정	love, affection
애프터서비스	after-sales service
액자	picture frame
앨범	album
야간	nighttime, during night
야경	night view
야근	overwork
야단맞다	to be scolded
야단치다	to scold
야외	outdoors
야유회	picnic
약하다	to be weak
약혼	engagement
약혼자	fiance
얌전하다	to be calm, to be gentle
양념	condiments, seasoning, spice
양로원	nursing home
양반	Yangban, nobility
양보	yielding, concession
양쪽	both
얘	this person
어기다	to violate
어느새	already, so soon
어떠하다	to be such a one's thoughts
어떡하다	to be such a one's thoughts
어려움	difficulty, hardship
어린아이	children
어린이날	Children's day
어버이날	Parent's day
어색하다	to be awkward
어쨌든	anyway
어쩌다가	coincidentally
어쩌면	maybe, possibly
어쩐지	somehow
어차피	after all, any way
어학	language
어학연수	language training
어휘	vocabulary
억	billion
억양	accent
억지로	forcibly
언론	mass media
언론인	journalist
언어	language
언젠가	someday
얻다	to obtain
얻어먹다	to get treated
얼다	to freeze
얼룩	stain
얼른	to be fast, to be quick
엄격하다	to be strict
엄청나다	to be tremendous, to be enormous
업무	work, job
없애다	to get rid of, to dispose of
엉덩이	butt
엉뚱하다	to be strange, to be bizarre
엉망	wreck, mess, ruin
엊그제	a few days ago
에너지	energy
에이즈	aids
엔진	engine
엠티	membership training
여가	leisure
여고생	high school girl
여관	hotel, inn
여드름	acne
여럿	many
여름날	summer day
여성	female
여성복	women's clothing
여유	spare, margin
여전히	just as it was before
여쭈다	to ask politely
여행비	travel expenses
여행자	traveler
여행지	travel destination
역사적	being historical
역시	as expected, after all
역할	role
연결	connection
연구	research
연구소	research institute
연구실	research laboratory
연극	theater
연기	delay, postponement, smoke, acting
연도	year
연락	communication
연말	end of the year
연말연시	new years holidays
연상	seniority, elder
연속	continuity
연속극	serial drama, soap opera
연수	training
연애	romance, courtship
연애결혼	love marriage
연인	couple
연장	extension
연주	performance
연주회	concert
연하	being a younger, younger person
연하다	to be soft, to supple
연회비	annual fee
열대야	a very hot night
열람실	reading room
열흘	10 days
염색	dyeing
엿	(Korean traditional) candy
영수증	receipt
영양	nutrition
영양가	nutritional value
영양분	nutrients
영양소	nutrients
영양제	nutritional supplement
영업	sales
영업부	sales department
영역	area
영원히	eternally, everlastingly, forever
영향	impact
영화감독	film director
영화제	film festival
옆집	a neighbor, the house next door
예금	(bank) deposit
예매	reservation, booking
예방	prevention
예보	forecast
예상	expectation
예술	art
예습	pre-view, preparation
예식장	wedding hall
예의	manner, etiquette
예전	past, old days
예절	manner, etiquette
예정	plans
예측	forecast
옛	old, ancient
옛말	old story, old speech, old tale
오가다	to come and go
오늘날	today
오락	entertainment
오래되다	to be old
오랜	long time
오르내리다	to go up and down
오른손	right hand
오리엔테이션	orientation
오염	pollution
오토바이	motorcycle
오페라	opera
오피스텔	officetel(office + hotel)
오해	misunderstanding
오히려	rather
온	all~, entire
온갖	various kinds of
온도	temperature
온돌	Ondol (Korean traditional heating system)
온돌방	room with Ondol
온라인	online
온몸	whole-body
온천	hot spring
온천욕	hot spring bath
온통	all, entire
올리다	to raise, to post
올림픽	olympic
올바르다	to be proper, to be honest
옳다	to be correct
옷차림	dress, clothing
와인	wine
완성	completion
완전히	completely
왕	king
왕복	round trip
왕비	queen
왠지	for some reason
외가	maternal
외과	surgery department
외교관	diplomat
외동딸	only daughter
외동아들	only son
외래어	loan word, borrowed word
외로움	loneliness
외모	appearance
외식	eating out
외아들	only son
외우다	to memorize
외치다	to scream, to shout
요가	yoga
요구	request
요구르트	yogurt
요리법	recipe
요리사	chef
요새	recently, these days
요약	summary
요청	request
욕	abusive language
욕실	bathroom
욕심	greed
욕심쟁이	greedy person
용	dragon
용기	courage
용돈	pocket money, allowance
용서	forgiveness
우등상	honor prize
우리말	Korean language
우물	well
우수성	excellence
우승	victory, championship
우아하다	to be graceful
우연	chance, accident
우연히	coincidentally
우울증	depression
우울하다	to be depressed
우정	friendship
우주	space
우주여행	space travel
우편	post
우편물	post mail
우편배달	mail delivery
운	luck
운명	fate
운전기사	driver
운전면허	driver's license
운전자	driver
울보	crybaby
울음	crying, tear
웃어른	superior, senior
웃음	laughter
워낙	very, basically
원고	manuscript
원래	originally
원룸	studio apartment
원리	principle
원서	application
원숭이	monkey
원인	cause
월말	end of month
웨딩드레스	wedding dress
위대하다	to be great
위로	consolation, comfort
위반	violation
윗사람	superior, senior
유난히	outstandingly, especially
유니폼	uniform
유람선	cruise ship
유료	being paid, being charged
유리창	window glass
유머	humor
유명	being famous
유적지	historic site
유창하다	to be fluent
유치원	kindergarten
유쾌하다	to be fun, to be cheerful
유행어	buzzword
육식	being carnivorous
육아	childcare
윷놀이	game of Yut, Yunnori
은	silver
은혜	favor, grace
음력	lunar calendar
음료	beverages, drink
음성	voice
음식물	food and drink
음식점	restaurant
음악회	musical concert
음주	drinking
응급실	emergency room
응답	response, answer
응답자	respondents
응시자	examinee
응원	cheering, support
의견	opinion
의논	consultation, discussion
의류	clothing
의무	obligation
의문	question
의사소통	communication
의상	clothing, costume
의식주	clothing, food, and housing
의심	doubt
의외로	unexpectedly
의욕	motivation
의의	significance, meaning, sense
의지	will
의하다	to be based on
의학	(field of) medicine
의학적	being medical
이것저것	this and that, various, everything
이국적	being exotic, being foreign
이기다	to win
이기적	being selfish
이끌다	to pull, to guide
이내	soon
이다	is
이동	move
이따	later
이때	at this time
이러하다	such, of this kind, of this sort
이런저런	this and that, various
이루다	to accomplish, to achieve, to compose
이루어지다	to be achieved, to be composed of
이름나다	to become famous
이름표	name tag
이리	this way
이리저리	here and there
이마	forehead
이만	this much of, at here
이만큼	this much
이미	already
이미지	image
이민	immigrants
이별	farewell
이불	blanket
이비인후과	otorhinolaryngology, ENT
이삿짐	belongings when moving house
이상형	an ideal type of person
이성	reason, the opposite sex
이어지다	to be connected
이어폰	earphone
이외	except, besides
이용료	usage fee
이용자	user
이웃	neighborhood
이웃집	neighbor
이익	profit
이자	interest
이전	before
이제야	finally now
이하	less than, below
이해력	comprehension, understanding
이해심	compassion, understanding
이혼	divorce
이후	afterward
익숙하다	well-known, familiar
익히다	to boil, to learn
인간	human
인간관계	relationships
인간성	human nature
인간적	being human
인류	human race
인사말	greeting words
인상적	being impressive
인생	life
인쇄	printing
인쇄물	printed papers
인스턴트	instant food
인원	number of people
인정받다	to be recognized, to be accepted
인출기	ATM
인턴사원	intern
인하다	to result from, to be caused by, to be due to
일기장	diary
일단	first of all, firstly
일등	first place
일반	ordinary
일반인	ordinary people
일반적	being ordinary
일부	part
일부러	on purpose
일상	daily life
일상적	being daily
일생	lifetime
일시	temporary
일시불	lump-sum payment
일으키다	to raise, to sit upright
일자리	workplace
일정	schedule
일정하다	to be uniform, to be constant
일출	sunrise
일회용품	disposable product
읽히다	to be read
임산부	pregnant woman
임시	temporary
임신	pregnancy
입금	deposit, payment on account
입맛	appetite
입술	lips
입시	entrance examination
입장	admission
입장권	admission ticket
입장료	admission fee
입학시험	entrance examination
입히다	to dress someone up
잇다	to connect, to tie, to continue
잎	leaf
자격	qualification
자격증	license, certificate
자극적	being provocative, being stimulating
자꾸	frequently
자녀	child
자동	automatic
자라다	to grow up
자랑	boast, brag, showing off
자료실	archive, reference room
자막	subtitles
자매	sisters
자살	suicide
자세하다	to be detailed, to be minute
자세히	in detail
자식	child, kid
자신감	confidence
자연적	being natural
자외선	ultraviolet rays
자원	resource
자음	consonant
자존심	self-esteem, pride
자취	living alone
자판기	vending machine
작가	writer
작곡	composition
작문	essay, writing
작사	writing lyrics
작아지다	to get smaller
작업	work, job, operation
작품	work, piece
잔돈	small money, small change
잔디	grass
잔디밭	grass field
잔뜩	full, much
잔소리	useless talk, idle talk
잔액	balance
잠그다	to lock (a door)
잠기다	to get locked, to submerged
잠들다	to fall asleep
잠옷	pajama
잠자리	dragonfly
잡수다	to eat (honorific)
잡아먹다	to prey on, to feed on
잡채	Japchae (Korean food)
잡히다	to get caught
장가	marriage (of men)
장가가다	to get married (of men)
장기적	being long term
장난	naughty, prank
장난감	toy
장난꾸러기	mischievous kid
장남	eldest son
장녀	eldest daughter
장단점	advantages and disadvantages
장래	future
장례식	funeral
장례식장	funeral hall
장바구니	shopping basket
장사	business
장애	disability
장애인	disabled people
장학	scholarship
장학금	scholarship
재발급	reissue
재산	wealth, property
재작년	two years ago
재주	talent, skills
재즈	jazz
재테크	investment techniques
재학	enrollment
재해	disaster
재혼	remarriage
재활용	recycling
재활용품	recycled goods
쟤	that person
저금	savings
저금통	piggybank
저렴하다	to be cheap
저울	scale (weight)
저장	storage, preservation
저절로	being natural, being automatic
저축	savings
적극적	being enthusiastic, being active
적금	installment savings
적당하다	to be appropriate
적당히	appropriately
적성	aptitude (for)
적어도	at least
적어지다	to get less
적응	adaptation
적절하다	to be suitable
전구	light bulb
전국	nationwide
전국적	being national
전기	electricity
전날	the day before
전달	delivery, conveyance
전동차	subway train
전등	lamp, light
전망	outlook
전문가	expert
전문적	being professional
전문점	specialty shop
전반전	first half
전부	all, entire
전산실	computer room
전세	security deposit system of housing
전셋집	rent house
전시	exhibition
전시회	exhibition
전원	power supply
전자	electron
전자레인지	microwave
전쟁	war
전철	subway, train
전체	entire
전체적	being overall
전통	tradition
전통문화	traditional culture
전통적	being traditional
전화벨	phone bell
절대로	definitely, absolutely
절반	half
절약	saving, frugality
젊은이	young people
젊음	youth
점잖다	to be well-mannered, to be gentle
점점	gradually, slowly
점차	gradually
접다	to fold, to quit
접수	reception
접하다	to encounter, to come into contact
정	affection
정기적	being regularly
정답	correct answer
정말로	really
정보화	informatization
정부	government
정상	normal
정상적	being normal
정성	sincerity, devotion
정성껏	with one's whole heart, elaborately
정신	mind, consciousness
정신없다	to be not in one's right mind
정신없이	hectically, frantically
정신적	being mental
정의	justice
정장	formal clothes, suits
정전	power outage
정지	stop
정직하다	to be honest
정차	stopping
정체	identity
정치	politics
정치가	politician
정치인	politician
정치학	political science
정확하다	to be accurate
정확히	accurately
젖다	to get wet, to get soaked
제공	offer
제대로	properly
제도	system
제때	on time
제발	please
제비	swallow
제사	ancestral rites, memorial service
제시간	on time
제안	suggestion
제자	student, disciple, follower
제자리	original place
제작	production
제출	submission
제품	product
제한	limit, restriction
조개	shellfish
조건	conditions
조교	assistant
조깅	jogging
조르다	to tighten, to pester
조리	cooking
조리법	recipe
조림	braised dish
조만간	sooner or later
조명	lighting, illumination
조미료	seasoning
조상	ancestor
조심	caution, carefulness
조절	adjustment
족발	pig's feet
존경	respect
졸다	to doze
졸리다	to be sleepy
졸업식	graduation ceremony
졸음	sleepiness
좀처럼	easily, anytime soon
좁히다	to narrow, to make something smaller
종교	religion
종이컵	paper cup
종종	from time to time, sometimes
종합	total, comprehensive
좌석	seat
좌우	left and right
좌회전	turn left
주거	residence
주고받다	to exchange
주년	anniversary/annual~
주름	wrinkles
주먹	fist
주문서	purchase order
주민	resident
주방	kitchen
주식회사	corporation
주어지다	to be given
주유소	gas station
주의	caution
주인공	main character
주장	assertion, captain
주제	subject, theme
주택	housing, residence
주택가	residential area
죽음	death
죽이다	to kill
준비물	belongings
줄거리	story, plot
줄무늬	striped pattern
줄어들다	to decrease
줄이다	to reduce, to shrink
줍다	to pick up
중간	middle
중개소	agency
중고	second hand
중고차	second-hand car
중고품	second-hand goods
중급	intermediate
중단	suspension
중부	central part
중소기업	small and medium-sized enterprises
중심지	capital, hub
중앙	central part
중요성	importance
쥐	mouse
즉	that is, which means
즐거움	joy, pleasure
증가	growth, rise
증명서	certificate
증상	symptoms
지겹다	to get tired, to get bored
지구	earth
지나가다	to pass by
지나치다	to be extreme, to be severe
지난해	last year
지루하다	to be boring
지붕	roof
지식	knowledge
지역	area
지옥	hell
지우다	to erase
지원	support
지원자	supporter
지위	status
지저분하다	to be messy, to be dirty
지점	point, branch
지진	earthquake
지출	expense, spending
지치다	to be tired, to be exhausted
지켜보다	to watch, to take care
지퍼	zipper
지휘자	conductor
직선	straight line
직장인	worker
직접적	being direct
직진	going straight
직후	immediately after
진실	truth
진심	sincerity
진짜	really, truly
진찰	medical examination
진통제	painkiller
진하다	to be thick, to be dark
진학	entrance to a higher educational institution
진행	progress
진행자	chairperson
질병	disease
질서	order
질투	jealousy
질환	disease
짐승	beast
집값	house price
집다	to grab
집들이	housewarming party
집세	rent
집안	family
집안일	housework
집주인	landlord
집중	concentration
집중력	concentration
짙다	to be thick, to be dark
짜증	frustration
짝	pair
짝사랑	crush, one side love
짝수	even number
쫓기다	to be chased
쫓다	to chase
쫓아내다	to kick out
쫓아다니다	to chase around
쭉	all the time
찌다	to get fat
찜질	sauna
찜통더위	humid heat
찢다	to break, to tear
찢어지다	to be torn, to be ripped
차라리	rather
차례	order
차분하다	to be calm, to be quiet
차이	difference
차이점	differences
착각	misunderstanding
찬물	cold water
찬성	agreement
참가	participation
참고	reference
참기름	sesame oil
참다	to endure
참석	attendance, participation
참여	participation
참치	tuna
찻집	café, teahouse
창	window
창피	shame, embarrassment
찾아내다	to find out
찾아다니다	to search around
찾아보다	to look for
채널	channel
채식	vegetarian
채식주의자	vegetarian person
채용	recruitment
채우다	to satisfy, to fill in
채팅	online chat
책임지다	to be in charge, to be responsible
챙기다	to pack, to prepare
처녀	virgin
처리	processing
처방	prescription
처방전	prescription
천국	heaven
천사	angel
천장	ceiling
천재	genius, natural disaster
철학	philosophy
첫날	first day
첫눈	first snow
첫사랑	first love
첫인상	first impression
청구서	invoice
청년	youth
청소년	teenager
청첩장	invitation
청혼	marriage proposal
체격	build, frame
체온	body temperature
체육	physical education
체육관	gym
체조	gymnastics
체중	bodyweight
체험	experience
쳐다보다	to stare, to look up
초급	beginner-level
초기	beginning, start
초대장	invitation
초보자	beginner
초청장	invitation
총	gun
총무과	general affairs division
촬영장	studio
촬영지	filming site
최근	recent
최대	maximum
최선	best
최신	latest
최저	minimum
최종	last, final
최초	the first
최후	last, final
추가	adding
추위	cold
추천	recommendation
추천서	letter of recommendation
추첨	drawing lots
추측	guess
출국	leaving a country
출근길	on the way to work
출력	output
출산	giving birth
출산율	birth rate
출생	birth
출석	attendance
출신	origin, affiliation
출입	access, enter
출입국	immigration
출퇴근	commuting
출판사	publishing company
충격	shock, impact
충고	advice
충돌	collision
충분하다	enough
충분히	enough, sufficiently, fully
취업	　　
취업난	unemployment crisis
취침	sleeping, going to bed
취하다	to get drunk
측	~side
치료제	treatment medicine
치수	size, measurement
치우다	to clean up, to remove
치즈	cheese
친어머니	biological mother
친환경	being eco-friendly
침	saliva
침실	bedroom
칭찬	compliment
카네이션	carnation
카세트	cassette
카센터	car repair shop
카페인	caffeine
카펫	carpet
칸	column, blank
칼국수	Korean style noodle
캄캄하다	to be very dark, to be pitch-dark
캠퍼스	campus
캠프	camping
커다랗다	to be extremely big
커지다	to get bigger, to grow
커튼	curtain
커플	couple
컴퓨터실	computer room
켜지다	to light up
코끼리	elephant
코너	corner
코미디	comedy
코미디언	comedian
콘서트	concert
콘센트	electrical outlet, socket
콩나물	bean sprouts
퀴즈	quiz
큰길	main road
큰돈	big money
큰소리	big voice, loud voice
큰일	important matter
클래식	classic
클릭	click
키우다	to nurture, to make it bigger
타입	type
탈	mask, disguise
탈의실	dressing room, fitting room
탈춤	Korean traditional mask dance
탑승구	boarding gate
탕	soup, juice
태도	attitude
태양	sun
태양열	solar heat
태우다	to burn, to bake
택배	delivery
택배비	delivery fee
터지다	to burst, to happen suddenly
털다	to shake off
테이프	tape
텐트	tent
토끼	rabbit
토론	discussion
토하다	to vomit
통계	statistics
통신	communication
통역	interpretation
통일	unification
통증	pain
통지서	notice
통화	phone call
퇴근길	way back from home
퇴원	being discharged from hospital
퇴직	retirement
투표	vote
튀기다	to fry, to bounce
트럭	truck
특기	specialty
특별	being special
특별하다	to be special
특산물	specialty, regional product
튼튼하다	to be durable, to be strong
틀림없다	to be sure enough
틀림없이	definitely
틈	crack, gap
티켓	ticket
팀장	team leader
파다	to dig down, to carve
파마	perm
파일	file
파전	Korean pancake
판매	sale
판매자	seller
팥빙수	Korean style shaved ice
패션쇼	fashion show
패스트푸드	fast food
팩스	fax
팬	fan
퍼지다	to spread
편리	convenience
편식	unbalanced diet
편안하다	to be comfortable
편의점	convenience store
편히	easily
펼치다	to spread
평가	evaluation
평균	average
평등	equal
평범하다	to be ordinary, to be usual, to be common
평생	forever
평소	usual day
평화	peace
포근하다	to be cozy
포기	to give up
포도주	wine
포인트	point
포장지	wrapping paper
폭발	explosion
폭설	heavy snow
폭식	binge eating
폭우	heavy rain
폭포	waterfall
표시	sign, mark
표정	facial expression
표지판	display board
푸르다	to be blue
풀리다	to be untied, to be relieved
풀이	interpretation
품질	quality
풍경	landscape
풍부하다	to be rich, to be abundant
풍선	balloon
프라이팬	frying pan
프로그래머	programmer
프린터	printer
플라스틱	plastic
플러그	plug
피로	fatigue
피부	skin
피부과	dermatology
피부병	skin disease
피서	summer vacation
피아니스트	pianist
피하다	to avoid
피해	damage
피해자	victim
필수	mandatory
필수품	necessities
필요성	necessity
핑계	excuse
하도	too, excessively
하루빨리	as soon as possible, immediately, quickly
하루하루	day by day
하룻밤	one night
하마터면	almost, nearly
하품	yawn
학과	department (at university)
학력	educational background
학문	academic field
학비	tuition fee
학습	learning, study
학자	scholar
학점	grade, credit
한가하다	to be leisurely, to be relaxed
한국학	Korean studies
한글날	Hangul day
한꺼번에	at once, together
한낮	midday
한눈	at a glance
한동안	temporarily, for a while
한두	one or two
한마디	a word
한순간	for a moment
한숨	sigh
한약	acupuncture medicine
한옥	Hanok (traditional Korean architecture)
한우	Korean beef
한의사	doctor of traditional Korean medicine
한정식	Korean set meal
한지	traditional Korean paper
한참	for a long time
한창	at its peak, in bloom
한편	on the other hand
할부	monthly installment plan
할인점	discount store
함부로	thoughtlessly, mindlessly
합격자	successful candidate, winner
합치다	to sum, to match
합하다	to add
항공	flight
항공권	flight ticket
항공기	aircraft
항공료	airfare
항공사	airlines
항공편	flight
해결	solution
해결책	solution
해고	layoff, discharge
해내다	to accomplish, to achieve
해돋이	sunrise
해롭다	to be harmful
해마다	annual, every year
해물	seafood
해보다	to try, to attempt
해산물	seafood
해소	solution
해소법	solution
해수욕	sea bathing
해수욕장	beach
해열제	antipyretic
핸드백	handbag
햇곡식	new grain
햇볕	sunlight
행동	action, behavior
행사장	event hall
행운	luck, fortune
향	scent
향기	fragrance
향수	perfume, nostalgia
향하다	to head
허락	permission
허리띠	belt, waistband
험하다	to be rough
헤매다	to wander, to get lost
헤어스타일	hairstyle
헤어지다	to break up, to leave
헤엄치다	to swim
헬멧	helmet
헬스클럽	sports club, gym
현관	entrance
현관문	entrance door
현대	present-day
현대식	modern style
현대인	modern people
현대적	being modern
현모양처	wise mother and good wife
현실	reality
현실적	being realistic
현장	on-site
형용사	adjective
형태	form
형편	situation, circumstances
혜택	grace, blessing
호감	favor
호기심	curiosity
호수	lake
호칭	name
혹시	maybe
혹은	or
혼나다	to get angry
혼내다	to scold
혼잡	confusion, mess, disorder
홀수	odd number
홍보	public relations
홍보물	promotion materials
홍수	flood
화려하다	to be fancy
화면	screen
화물	cargo
화분	flowerpot
화산	volcano
화상	burn, scald
화장지	toilet paper
화재	fire
화창하다	to be fine, to be clear, to be bright
화해	reconciliation, settlement, compromise
확실하다	to be sure
환경	environment
환기	ventilation
환불	refund
환상적	being fantastic
환송회	farewell party
환영회	welcome party
환율	exchange rate
환전	currency exchange
환절기	seasonal change
활동	activities
활동적	being active
활발하다	to be active
활용	utilization
활짝	in full bloom
황당하다	to be absurd, to be nonsensical, to be ridiculous
황사	yellow dust, asian dust
～회	~ times
회갑	one's 60th birthday
회복	recovery
회비	membership fee
회식	group dinner, drinking party
회원	member
회의장	conference hall
회장	president
횟수	number of times
효과	effect
효과적	being effective
효녀	devoted daughter
효율적	being efficient
후문	back gate
후반	later half
후반전	second half
후보	candidate
후식	dessert
후회	regret
훈련	training
훌륭하다	to be great, to be excellent
훔치다	to steal
훨씬	much, far, a lot
휘발유	gasoline
휴가철	holiday season
휴게실	break-out room, lounge
휴대	mobile
휴대폰	mobile phone
휴식	rest
휴양지	resort
휴학	leave of absence (from school)
흐르다	to flow, to run
흔들다	to shake
흔들리다	to wave, to shake
흔하다	to be common
흔히	commonly, often
흘리다	to spill, to shed
흙	soil
흡연	smoking
흥미	interest
흥분	excitement
희다	to be white
희망	hope
희망자	applicant
희생자	victim
힘껏	with all one's strength
